Chamisa, Mnagagwa, Mnagagwa - Chamisa, % Mnagagwa - Chamisa, DISTRICT,CONSTITUENCY,LOCAL AUTHORITY,WARD NO.,POLLING STATION,STATION CODE
15,214,199,86,Chirumanzu,Chirumanzu,Takawira RDC,4,Juru/Godza Business Centre Tent,7700TAK0404
17,228,211,86,Chirumanzu,Chirumanzu/Zibagwe,Takawira RDC,12,Maware Primary School,7700TAK1204
17,223,206,85,Chirumanzu,Chirumanzu/Zibagwe,Takawira RDC,15,Nyikavanhu Primary School,7700TAK1504
10,142,132,86,Chirumanzu,Chirumanzu/Zibagwe,Takawira RDC,16,Mudzengi Primary School,7700TAK1604
33,337,304,82,Chirumanzu,Chirumanzu/Zibagwe,Takawira RDC,16,Utah Primary School,7700TAK1605
22,346,324,88,Chirumanzu,Chirumanzu/Zibagwe,Takawira RDC,19,Game Park Lodge Tent,7700TAK1904
5,135,130,92,Chirumanzu,Chirumanzu/Zibagwe,Takawira RDC,19,Manyora Homestead Tent,7700TAK1905
10,218,208,91,Chirumanzu,Chirumanzu/Zibagwe,Takawira RDC,19,Piki Business Centre Tent,7700TAK1908
20,202,182,81,Chirumanzu,Chirumanzu/Zibagwe,Takawira RDC,20,Chakasteadt Primary School,7700TAK2001
21,206,185,81,Chirumanzu,Chirumanzu/Zibagwe,Takawira RDC,20,Village 9 Tent,7700TAK2010
3,49,46,88,Chirumanzu,Chirumanzu/Zibagwe,Takawira RDC,22,Makomborero Co-operative Tent,7700TAK2203
22,232,210,82,Kwekwe,Chirumanzu/Zibagwe,Zibagwe RDC,1,Milsonia Village 9 Tent,5800ZBG0104
21,226,205,82,Kwekwe,Chirumanzu/Zibagwe,Zibagwe RDC,1,Mopani Park Primary School,5800ZBG0105
14,135,121,81,Kwekwe,Chirumanzu/Zibagwe,Zibagwe RDC,1,Sultana Farm House,5800ZBG0107
3,89,86,93,Kwekwe,Chirumanzu/Zibagwe,Zibagwe RDC,2,Lorraine farm house Farm,5800ZBG0203
34,383,349,83,Kwekwe,Chirumanzu/Zibagwe,Zibagwe RDC,2,Pauldale Primary School,5800ZBG0205
23,261,238,83,Kwekwe,Chirumanzu/Zibagwe,Zibagwe RDC,2,Rockvale Farm Tent,5800ZBG0206
18,283,265,88,Kwekwe,Chirumanzu/Zibagwe,Zibagwe RDC,31,Belgrave House Farm,5800ZBG3101
30,304,274,82,Kwekwe,Chirumanzu/Zibagwe,Zibagwe RDC,31,Bonwei Primary School,5800ZBG3102
31,410,379,85,Kwekwe,Chirumanzu/Zibagwe,Zibagwe RDC,31,Creek Delville Wood Farm Tent,5800ZBG3103
16,188,172,84,Gokwe North,Gokwe-Chireya,Gokwe North RDC,4,Chiromo Primary School,2600GON0402
6,435,429,97,Gokwe North,Gokwe-Chireya,Gokwe North RDC,4,Mavimbi Primary School,2600GON0406
13,390,377,93,Gokwe North,Gokwe-Chireya,Gokwe North RDC,7,Chomukuyu Primary School,2600GON0702
36,805,769,91,Gokwe North,Gokwe-Chireya,Gokwe North RDC,7,Murunguziva Primary School,2600GON0705
44,437,393,81,Gokwe North,Gokwe-Chireya,Gokwe North RDC,9,Jaramba Point Tent,2600GON0901
2,165,163,97,Gokwe North,Gokwe-Chireya,Gokwe North RDC,9,Mukamba Tent,2600GON0903
17,202,185,84,Gokwe North,Gokwe-Chireya,Gokwe North RDC,10,Masosoni Primary School,2600GON1003
29,692,663,91,Gokwe North,Gokwe-Chireya,Gokwe North RDC,10,Mudondo Primary School,2600GON1004
37,474,437,85,Gokwe North,Gokwe-Chireya,Gokwe North RDC,33,Chiodza Primary School,2600GON3301
26,440,414,88,Gokwe North,Gokwe-Chireya,Gokwe North RDC,33,New Mine Primary School,2600GON3304
65,647,582,81,Gokwe North,Gokwe-Chireya,Gokwe North RDC,35,Musape Ground Tent,2600GON3503
9,160,151,89,Gokwe North,Gokwe-Gumunyu,Gokwe North RDC,17,Chimhamhari Business Centre Tent,2600GON1701
25,372,347,87,Gokwe North,Gokwe-Gumunyu,Gokwe North RDC,17,Nyamatsito Primary School,2600GON1705
25,375,350,87,Gokwe North,Gokwe-Gumunyu,Gokwe North RDC,18,Mawere Collect Point Tent,2600GON1804
19,351,332,89,Gokwe North,Gokwe-Gumunyu,Gokwe North RDC,18,Zvanaka Primary School,2600GON1805
45,429,384,81,Gokwe North,Gokwe-Gumunyu,Gokwe North RDC,20,Hwadze Primary School,2600GON2002
33,486,453,87,Gokwe North,Gokwe-Gumunyu,Gokwe North RDC,20,Village 17b Tent,2600GON2004
50,621,571,85,Gokwe North,Gokwe-Gumunyu,Gokwe North RDC,21,Mangorohwe Primary School,2600GON2101
6,266,260,95,Gokwe North,Gokwe-Gumunyu,Gokwe North RDC,21,Mbowa Business Centre Tent,2600GON2102
27,477,450,89,Gokwe North,Gokwe-Gumunyu,Gokwe North RDC,21,Village 10b Tent,2600GON2105
12,836,824,97,Gokwe North,Gokwe-Gumunyu,Gokwe North RDC,22,Copper Queen Mine Tent,2600GON2201
22,364,342,88,Gokwe North,Gokwe-Gumunyu,Gokwe North RDC,22,Mutukanyi Primary School,2600GON2204
25,287,262,83,Gokwe North,Gokwe-Gumunyu,Gokwe North RDC,32,Budiriro Primary School,2600GON3201
9,167,158,89,Gokwe North,Gokwe-Gumunyu,Gokwe North RDC,32,Makwiyo Business Centre Tent,2600GON3203
22,219,197,81,Gokwe North,Gokwe-Gumunyu,Gokwe North RDC,32,Mutsiva Dip Tank Tent,2600GON3204
30,432,402,87,Gokwe North,Gokwe-Kabuyuni,Gokwe North RDC,3,Hongoro Primary School,2600GON0302 A
39,430,391,83,Gokwe North,Gokwe-Kabuyuni,Gokwe North RDC,3,Hongoro Primary School,2600GON0302 B
19,436,417,91,Gokwe North,Gokwe-Kabuyuni,Gokwe North RDC,5,Chemhondoro Primary School,2600GON0501 A
16,438,422,92,Gokwe North,Gokwe-Kabuyuni,Gokwe North RDC,5,Chemhondoro Primary School,2600GON0501 B
64,757,693,84,Gokwe North,Gokwe-Kabuyuni,Gokwe North RDC,5,Chidora Primary School,2600GON0502
7,357,350,96,Gokwe North,Gokwe-Kabuyuni,Gokwe North RDC,27,Maranga Point Tent,2600GON2701
40,527,487,85,Gokwe South,Gokwe Central,Gokwe South RDC,19,Zanda Business Centre Tent,2300GOS1908
5,310,305,96,Gokwe South,Gokwe Central,Gokwe South RDC,20,Chikodzongo Business Centre Tent,2300GOS2002
37,445,408,84,Gokwe South,Gokwe Kana,Gokwe South RDC,26,Kambe Primary School,2300GOS2602
15,321,306,91,Gokwe South,Gokwe Kana,Gokwe South RDC,26,Ndandulo Business Centre Tent,2300GOS2604
32,507,475,88,Gokwe South,Gokwe Mapfungautsi,Gokwe South RDC,24,Makadhi Business Centre Tent,2300GOS2404
34,416,382,84,Gokwe South,Gokwe Sengwa,Gokwe South RDC,4,Manyena Primary School,2300GOS0404
46,480,434,82,Gokwe South,Gokwe Sengwa,Gokwe South RDC,6,Guyu Business Centre Tent,2300GOS0602
20,256,236,85,Gweru,Chiwundura,Vungu RDC,9,Riverdale Primary School,2900VUN0905
17,188,171,83,Gweru,Chiwundura,Vungu RDC,16,Lourdon Primary School,2900VUN1604
31,394,363,85,Gweru,Chiwundura,Vungu RDC,16,Stormvale Tent,2900VUN1609
32,358,326,83,Gweru,Vungu,Vungu RDC,1,North Shangani Homestead,2900VUN0103
6,96,90,88,Gweru,Vungu,Vungu RDC,17,Drummond Farm House Tent,2900VUN1702
19,244,225,85,Gweru,Vungu,Vungu RDC,19,Julena Primary School,2900VUN1902
21,282,261,86,Kwekwe,Redcliff,Zibagwe RDC,3,Bonaccord Primary School,5800ZBG0301
23,237,214,82,Kwekwe,Redcliff,Zibagwe RDC,3,Melrose Primary School,5800ZBG0304
20,276,256,86,Kwekwe,Redcliff,Zibagwe RDC,3,Newlands Primary School,5800ZBG0305
24,306,282,85,Kwekwe,Redcliff,Zibagwe RDC,3,Swaartlagte Primary School,5800ZBG0308
39,403,364,82,Kwekwe,Redcliff,Zibagwe RDC,24,Langton Farm Tent.,5800ZBG2402 A
43,410,367,81,Kwekwe,Redcliff,Zibagwe RDC,24,Langton Farm Tent.,5800ZBG2402 B
12,129,117,82,Kwekwe,Redcliff,Zibagwe RDC,30,Amatava Farm House Tent,5800ZBG3001
11,123,112,83,Kwekwe,Redcliff,Zibagwe RDC,30,Erin Homestead Tent,5800ZBG3002
22,215,193,81,Kwekwe,Redcliff,Zibagwe RDC,30,Hurudza Primary School,5800ZBG3003
54,561,507,82,Kwekwe,Redcliff,Zibagwe RDC,30,Moyo (Bvumira) Primary School,5800ZBG3005
5,79,74,88,Kwekwe,Redcliff,Zibagwe RDC,30,Penwarden Farm Tent,5800ZBG3006
18,206,188,83,Kwekwe,Silobela,Zibagwe RDC,4,Maywood Primary School,5800ZBG0404
49,545,496,83,Kwekwe,Silobela,Zibagwe RDC,5,Kotamayi Primary School,5800ZBG0501
18,485,467,92,Kwekwe,Silobela,Zibagwe RDC,5,Zivagwe Primary School,5800ZBG0504
47,480,433,82,Kwekwe,Silobela,Zibagwe RDC,15,Mutimutema Primary School,5800ZBG1502
12,174,162,87,Kwekwe,Silobela,Zibagwe RDC,17,Gwarazimba Business Centre Tent,5800ZBG1702
3,137,134,95,Mberengwa,Mberengwa North,Mberengwa RDC,1,Zion Church Tent,0300MBG0103
37,364,327,81,Mberengwa,Mberengwa North,Mberengwa RDC,1,Zvikombe Primary School,0300MBG0104
10,454,444,95,Mberengwa,Mberengwa North,Mberengwa RDC,2,Chomubhobho Business Centre Tent A,0300MBG0201 A
17,454,437,92,Mberengwa,Mberengwa North,Mberengwa RDC,2,Chomubhobho Business Centre Tent B,0300MBG0201 B
10,733,723,97,Mberengwa,Mberengwa North,Mberengwa RDC,2,Ivhukuvanhu Primary School,0300MBG0202
8,79,71,81,Mberengwa,Mberengwa North,Mberengwa RDC,2,Rupemba Primary School,0300MBG0205
51,494,443,81,Mberengwa,Mberengwa North,Mberengwa RDC,2,Vanguard Primary School A,0300MBG0206 A
47,480,433,82,Mberengwa,Mberengwa North,Mberengwa RDC,2,Vanguard Primary School B,0300MBG0206 B
29,389,360,86,Mberengwa,Mberengwa North,Mberengwa RDC,15,Magavakava Primary School,0300MBG1502
33,495,462,87,Mberengwa,Mberengwa North,Mberengwa RDC,35,Cheshumba Primary School,0300MBG3501
16,505,489,93,Mberengwa,Mberengwa North,Mberengwa RDC,35,Gwengwena Primary School,0300MBG3502
33,552,519,88,Mberengwa,Mberengwa North,Mberengwa RDC,35,Kushinga Primary School A,0300MBG3503 A
47,516,469,83,Mberengwa,Mberengwa North,Mberengwa RDC,35,Kushinga Primary School B,0300MBG3503 B
13,227,214,89,Mberengwa,Mberengwa North,Mberengwa RDC,35,Mberengwa Vocational Training Centre,0300MBG3504
39,587,548,87,Mberengwa,Mberengwa North,Mberengwa RDC,36,Bungwe Primary School,0300MBG3601
27,442,415,88,Mberengwa,Mberengwa North,Mberengwa RDC,36,C-Mine Clinic Tent,0300MBG3603
68,686,618,81,Mberengwa,Mberengwa North,Mberengwa RDC,36,Neta Business Centre Tent,0300MBG3605
32,376,344,84,Mberengwa,Mberengwa South,Mberengwa RDC,19,Garenyama Primary School,0300MBG1901
13,260,247,90,Mberengwa,Mberengwa South,Mberengwa RDC,24,Shayamavhudzi Business Centre Tent,0300MBG2403
28,359,331,85,Mberengwa,Mberengwa South,Mberengwa RDC,24,Vambare Primary School,0300MBG2404
14,231,217,88,Mberengwa,Mberengwa South,Mberengwa RDC,25,Mketi Clinic,0300MBG2501
18,236,218,85,Mberengwa,Mberengwa South,Mberengwa RDC,25,Sviba Primary School,0300MBG2504
20,210,190,82,Mberengwa,Mberengwa South,Mberengwa RDC,26,Chiturike Business Centre Tent,0300MBG2601
23,280,257,84,Mberengwa,Mberengwa South,Mberengwa RDC,27,Zebra Business Centre Tent,0300MBG2704
39,507,468,85,Mberengwa,Mberengwa South,Mberengwa RDC,28,Machingwe Primary School,0300MBG2802
7,80,73,83,Mberengwa,Mberengwa South,Mberengwa RDC,28,Makuta Business Centre Tent,0300MBG2803
7,232,225,94,Mberengwa,Mberengwa South,Mberengwa RDC,28,Masaga Business Centre Tent,0300MBG2805
32,306,274,81,Mberengwa,Mberengwa West,Mberengwa RDC,14,Chebvute Primary School,0300MBG1402
11,447,436,95,Mberengwa,Mberengwa West,Mberengwa RDC,29,Chimbapire Primary School,0300MBG2902
36,410,374,83,Mberengwa,Mberengwa West,Mberengwa RDC,29,Sandawana Primary School,0300MBG2905 B
17,179,162,82,Shurugwi,Shurugwi North,Tongogara RDC,1,Munikwa Primary School,6600TON0102
31,313,282,81,Shurugwi,Shurugwi North,Tongogara RDC,1,Tangley Ranch Primary School,6600TON0103
17,227,210,86,Shurugwi,Shurugwi North,Tongogara RDC,16,Dopota Primary School,6600TON1603
27,306,279,83,Shurugwi,Shurugwi North,Tongogara RDC,17,Beacon Kop Primary School,6600TON1701
12,128,116,82,Shurugwi,Shurugwi North,Tongogara RDC,17,Highlands Farm House Tent,6600TON1703
33,416,383,85,Shurugwi,Shurugwi North,Tongogara RDC,18,Boterekwa Primary School,6600TON1802
18,185,167,82,Shurugwi,Shurugwi North,Tongogara RDC,18,Mangwende Farm House Tent,6600TON1810
9,225,216,92,Shurugwi,Shurugwi North,Tongogara RDC,18,Pompey 2 Mine (William) Tent,6600TON1812
19,306,287,88,Shurugwi,Shurugwi North,Tongogara RDC,19,Gutsaruzhinji Primary School,6600TON1902
24,346,322,87,Shurugwi,Shurugwi South,Tongogara RDC,20,Marishongwe Primary School,6600TON2002
15,345,330,91,Shurugwi,Shurugwi South,Tongogara RDC,21,Reitfontein Tent,6600TON2103
28,440,412,88,Zvishavane,Zvishavane Ngezi,Runde RDC,3,Lundi Primary School,6700RDC0301
25,365,340,87,Zvishavane,Zvishavane Ngezi,Runde RDC,3,Muzvondiwa Business Centre Community Hall Tent,6700RDC0302
11,411,400,94,Zvishavane,Zvishavane Ngezi,Runde RDC,19,Zeederberg Borehole Tent,6700RDC1906
20,234,214,84,Zvishavane,Zvishavane Runde,Runde RDC,4,Mavhumashava Open Space Tent,6700RDC0401
20,235,215,84,Zvishavane,Zvishavane Runde,Runde RDC,8,Chamini Primary School,6700RDC0801
21,401,380,90,Zvishavane,Zvishavane Runde,Runde RDC,14,Chedope Primary School,6700RDC1401
36,502,466,86,Zvishavane,Zvishavane Runde,Runde RDC,14,Chirere Primary School,6700RDC1402
6,109,103,89,Zvishavane,Zvishavane Runde,Runde RDC,14,Finale Homestead Tent,6700RDC1403
20,319,299,88,Zvishavane,Zvishavane Runde,Runde RDC,14,Gwemvurachena Primary School,6700RDC1404
13,196,183,87,Beitbridge,Beitbridge East,Beitbridge RDC,1,Malabe Primary School,0200BBE0105
21,244,223,84,Beitbridge,Beitbridge East,Beitbridge RDC,2,Chabili Primary School,0200BBE0201
2,68,66,94,Beitbridge,Beitbridge East,Beitbridge RDC,2,Chapongwe Primary School,0200BBE0202
5,52,47,82,Beitbridge,Beitbridge East,Beitbridge RDC,2,Lukumbwe Diptank Tent,0200BBE0205
39,594,555,87,Beitbridge,Beitbridge East,Beitbridge RDC,3,Madaula Primary School,0200BBE0303
16,332,316,90,Beitbridge,Beitbridge East,Beitbridge RDC,3,Makombe Primary School,0200BBE0304
2,139,137,97,Beitbridge,Beitbridge East,Beitbridge RDC,3,Mandate Primary School,0200BBE0305
16,209,193,85,Beitbridge,Beitbridge East,Beitbridge RDC,6,Umzingwane Primary School,0200BBE0605
12,209,197,89,Beitbridge,Beitbridge East,Beitbridge RDC,13,Joko Primary School,0200BBE1302
2,132,130,97,Beitbridge,Beitbridge East,Beitbridge RDC,13,Kayansee (Matizwi) Primary School,0200BBE1303
15,268,253,89,Beitbridge,Beitbridge East,Beitbridge RDC,13,Lesanth Primary School,0200BBE1304
20,312,292,87,Beitbridge,Beitbridge West,Beitbridge RDC,4,Mugaladivha Primary School,0200BBE0404
5,108,103,91,Beitbridge,Beitbridge West,Beitbridge RDC,8,Shashe number 15 Tent,0200BBE0805
13,133,120,82,Beitbridge,Beitbridge West,Beitbridge RDC,10,Novhe Area Tent,0200BBE1004
21,210,189,81,Beitbridge,Beitbridge West,Beitbridge RDC,14,Mudzwiti Primary School,0200BBE1404
13,143,130,83,Bulilima,Bulilima East,Bulilima RDC,19,Fairview Primary School,5600BLM1902
1,73,72,97,Bulilima,Bulilima East,Bulilima RDC,19,Watershed Farm Tent,5600BLM1908
7,94,87,86,Bulilima,Bulilima West,Bulilima RDC,7,Muke Primary School,5600BLM0705
6,59,53,81,Bulilima,Bulilima West,Bulilima RDC,16,Village 18 Tent,5600BLM1603
8,101,93,85,Gwanda,Gwanda Central,Gwanda RDC,21,Moodspruit Primary School,2800GWA2105
0,17,17,100,Gwanda,Gwanda Central,Gwanda RDC,22,Sissyvale Primary School,2800GWA2205
9,265,256,93,Gwanda,Gwanda Central,Gwanda RDC,22,Zindele Primary School,2800GWA2208
20,295,275,87,Gwanda,Gwanda Central,Gwanda RDC,23,Driehoek Primary School,2800GWA2301
22,598,576,92,Gwanda,Gwanda Central,Gwanda RDC,23,Dwala Primary School,2800GWA2302
22,238,216,83,Gwanda,Gwanda Central,Gwanda RDC,23,Mabheka Primary School,2800GWA2303
19,196,177,82,Gwanda,Gwanda Central,Gwanda RDC,23,Tshabezi Primary School,2800GWA2305
153,13,-140,-84,Gwanda,Gwanda North,Gwanda RDC,5,Mtshabezi Primary School,2800GWA0502
176,14,-162,-85,Gwanda,Gwanda North,Gwanda RDC,7,Gqalaza Primary School,2800GWA0701
5,68,63,86,Insiza,Insiza North,Insiza RDC,13,Goedgedacht Homestead Tent,2100INZ1304
34,619,585,89,Insiza,Insiza North,Insiza RDC,20,Mpopoti Primary School,2100INZ2001
40,541,501,86,Insiza,Insiza North,Insiza RDC,20,Mthwakazi A Primary School,2100INZ2002
32,556,524,89,Insiza,Insiza North,Insiza RDC,20,Mthwakazi B Primary School,2100INZ2003
28,517,489,89,Insiza,Insiza North,Insiza RDC,21,Garawafamba Pre-School Tent,2100INZ2101
6,88,82,87,Insiza,Insiza North,Insiza RDC,21,Gwamanyanga A Primary School,2100INZ2102
30,419,389,86,Insiza,Insiza North,Insiza RDC,21,Gwamanyanga B Primary School A,2100INZ2103 A
27,416,389,87,Insiza,Insiza North,Insiza RDC,21,Gwamanyanga B Primary School B,2100INZ2103 B
4,60,56,87,Mangwe,Mangwe,Mangwe RDC,11,Hannavale Farm Tent,5600MAN1101
8,92,84,84,Mangwe,Mangwe,Mangwe RDC,11,Mabunga Primary School,5600MAN1103
8,162,154,90,Matobo,Matobo North,Matobo RDC,21,Makupa Primary School,3900MTB2101
2,59,57,93,Matobo,Matobo North,Matobo RDC,21,Mashaladze Primary School,3900MTB2102
5,0,-5,-100,Matobo,Matobo North,Matobo RDC,21,Pagati Primary School,3900MTB2103
6,143,137,91,Matobo,Matobo North,Matobo RDC,23,Sibuntule Primary School,3900MTB2301
5,136,131,92,Matobo,Matobo North,Matobo RDC,23,Vimbi Resettlement Tent,3900MTB2302
13,147,134,83,Matobo,Matobo North,Matobo RDC,24,Jeqe Business Centre Tent,3900MTB2401
9,194,185,91,Matobo,Matobo North,Matobo RDC,24,Sydney Malunga Primary School,3900MTB2403
18,179,161,81,Umzingwane,Umzingwane,Umzingwane RDC,14,BAYETHE Primary School,8700UMZ1402
10,207,197,90,Umzingwane,Umzingwane,Umzingwane RDC,14,Malungwane Primary School,8700UMZ1403
11,129,118,84,Umzingwane,Umzingwane,Umzingwane RDC,17,Mpofini Primary School,8700UMZ1702
3,483,480,98,Bindura,Bindura North,Bindura RDC,1,Banwell Farm Tent,0500BIN0101
6,539,533,97,Bindura,Bindura North,Bindura RDC,1,Chumbere Primary School,0500BIN0102
16,645,629,95,Bindura,Bindura North,Bindura RDC,1,Dimitra Primary School,0500BIN0103
11,719,708,96,Bindura,Bindura North,Bindura RDC,1,Manga Primary School A,0500BIN0104 A
11,707,696,96,Bindura,Bindura North,Bindura RDC,1,Manga Primary School B,0500BIN0104 B
12,459,447,94,Bindura,Bindura North,Bindura RDC,2,Aschott Primary School,0500BIN0201
8,416,408,96,Bindura,Bindura North,Bindura RDC,2,Azikara Farm Tent,0500BIN0202
6,517,511,97,Bindura,Bindura North,Bindura RDC,2,Frinton Farm Tent,0500BIN0203
16,735,719,95,Bindura,Bindura North,Bindura RDC,2,Matepatepa Country Club,0500BIN0204
17,481,464,93,Bindura,Bindura North,Bindura RDC,2,Mazunga Primary School,0500BIN0205
1,133,132,98,Bindura,Bindura North,Bindura RDC,2,Terregwai Farm Tent,0500BIN0206
20,672,652,94,Bindura,Bindura North,Bindura RDC,3,Chomukute Pre-School,0500BIN0301
11,159,148,87,Bindura,Bindura North,Bindura RDC,3,Duntarvie Farm Tent,0500BIN0302
15,357,342,91,Bindura,Bindura North,Bindura RDC,3,Dorper Farm Tent,0500BIN0303
13,448,435,94,Bindura,Bindura North,Bindura RDC,3,Hinton Estates Tent,0500BIN0304
18,500,482,93,Bindura,Bindura North,Bindura RDC,3,Lagnaha farm Tent,0500BIN0305
13,863,850,97,Bindura,Bindura North,Bindura RDC,3,Mabwemachena Secondary School,0500BIN0306
4,269,265,97,Bindura,Bindura North,Bindura RDC,3,Makori Range Primary School,0500BIN0307
40,641,601,88,Bindura,Bindura North,Bindura RDC,3,Rosetta Rust Primary School,0500BIN0308
2,159,157,97,Bindura,Bindura North,Bindura RDC,4,Bodele farm Tent,0500BIN0401
5,164,159,94,Bindura,Bindura North,Bindura RDC,4,Chiveri Farm,0500BIN0402
8,339,331,95,Bindura,Bindura North,Bindura RDC,4,Condwelani farm Tent,0500BIN0403
44,592,548,86,Bindura,Bindura North,Bindura RDC,4,Guitingwood farm Tent,0500BIN0404
40,555,515,86,Bindura,Bindura North,Bindura RDC,4,Mupfurudzi Settlement Tent,0500BIN0405
5,273,268,96,Bindura,Bindura North,Bindura RDC,4,Nyamuyambuka Tent,0500BIN0406
54,805,751,87,Bindura,Bindura North,Bindura RDC,4,Retreat/Kambira Primary School,0500BIN0407
42,624,582,87,Bindura,Bindura North,Bindura RDC,5,Craigside Farm Tent,0500BIN0501
17,628,611,94,Bindura,Bindura North,Bindura RDC,5,Dondori Primary School,0500BIN0502
33,852,819,92,Bindura,Bindura North,Bindura RDC,5,St Basil Primary School,0500BIN0503
3,250,247,97,Bindura,Bindura North,Bindura RDC,5,Tarlington Farm Tent,0500BIN0504
19,383,364,90,Bindura,Bindura North,Bindura RDC,7,Chipadze Farm Secondary School,0500BIN0701
27,843,816,93,Bindura,Bindura North,Bindura RDC,7,Chiwaridza Farm Tent,0500BIN0702
8,424,416,96,Bindura,Bindura North,Bindura RDC,19,Benwell Farm Tent,0500BIN1901
20,492,472,92,Bindura,Bindura North,Bindura RDC,19,Irenedale Farm Tent,0500BIN1903
5,313,308,96,Bindura,Bindura North,Bindura RDC,19,Jesmond Dean Estate Tent,0500BIN1904
1,44,43,95,Bindura,Bindura North,Bindura RDC,19,Sydenham Farm Tent,0500BIN1906
11,282,271,92,Bindura,Bindura North,Bindura RDC,20,Avoca Primary School,0500BIN2001
14,478,464,94,Bindura,Bindura North,Bindura RDC,20,Nethergreen Primary School A,0500BIN2004 A
33,460,427,86,Bindura,Bindura North,Bindura RDC,20,Nethergreen Primary School B,0500BIN2004 B
25,445,420,89,Bindura,Bindura North,Bindura RDC,20,Zvakwana Primary School,0500BIN2006
22,344,322,87,Bindura,Bindura South,Bindura RDC,6,Brinkburn Farm Tent,0500BIN0601
22,369,347,88,Bindura,Bindura South,Bindura RDC,6,Gosforth Farm Tent,0500BIN0604
25,513,488,90,Bindura,Bindura South,Bindura RDC,8,Burnside (Bemberero) Primary School,0500BIN0801
8,321,313,95,Bindura,Bindura South,Bindura RDC,8,Ruwanga Farm Tent,0500BIN0802
62,710,648,83,Bindura,Bindura South,Bindura RDC,8,SOS Maizelands Primary School,0500BIN0803
24,580,556,92,Bindura,Bindura South,Bindura RDC,8,The Vale Farm Tent,0500BIN0804
8,483,475,96,Bindura,Bindura South,Bindura RDC,21,Geluk Farm Tent,0500BIN2102
21,467,446,91,Bindura,Bindura South,Bindura RDC,21,Saimoona Primary School A,0500BIN2106 A
36,451,415,85,Bindura,Bindura South,Bindura RDC,21,Saimoona Primary School B,0500BIN2106 B
28,340,312,84,Bindura,Bindura South,Bindura RDC,21,Thrums Primary School,0500BIN2107
10,580,570,96,Guruve,Guruve North,Guruve RDC,2,Chikwidibe Primary School A,7100GVE0201 A
8,579,571,97,Guruve,Guruve North,Guruve RDC,2,Chikwidibe Primary School B,7100GVE0201 B
13,554,541,95,Guruve,Guruve North,Guruve RDC,2,Matare Primary School,7100GVE0202
41,482,441,84,Guruve,Guruve North,Guruve RDC,2,Nyamanji Primary School,7100GVE0203
35,342,307,81,Guruve,Guruve North,Guruve RDC,4,Matsvitsi Secondary School,7100GVE0402
36,660,624,89,Guruve,Guruve North,Guruve RDC,4,Rufaro Primary School,7100GVE0404
7,512,505,97,Guruve,Guruve North,Guruve RDC,16,Kaminza Business Centre Tent,7100GVE1601
31,484,453,87,Guruve,Guruve North,Guruve RDC,16,Murimbika Village Tent,7100GVE1603
4,607,603,98,Guruve,Guruve North,Guruve RDC,17,Rungudzi Clinic Tent,7100GVE1702
32,361,329,83,Guruve,Guruve North,Guruve RDC,18,Chiweshe Business Centre Tent,7100GVE1803
21,472,451,91,Guruve,Guruve North,Guruve RDC,19,Chiropa Business Centre Tent,7100GVE1901
13,621,608,95,Guruve,Guruve North,Guruve RDC,19,Negomo Primary School A,7100GVE1902 A
29,607,578,90,Guruve,Guruve North,Guruve RDC,19,Negomo Primary School B,7100GVE1902 B
12,457,445,94,Guruve,Guruve North,Guruve RDC,19,Nyagumbo Primary School A,7100GVE1903 A
11,453,442,95,Guruve,Guruve North,Guruve RDC,19,Nyagumbo Primary School B,7100GVE1903 B
33,651,618,90,Guruve,Guruve North,Guruve RDC,21,Gwakwe Primary School A,7100GVE2101 A
24,647,623,92,Guruve,Guruve North,Guruve RDC,21,Gwakwe Primary School B,7100GVE2101 B
7,235,228,94,Guruve,Guruve North,Guruve RDC,21,Manovi Farm Tent,7100GVE2102
17,514,497,93,Guruve,Guruve North,Guruve RDC,21,Mutota Primary School,7100GVE2103
6,600,594,98,Guruve,Guruve North,Guruve RDC,21,Nyamuseve Secondary School,7100GVE2104
13,388,375,93,Guruve,Guruve North,Guruve RDC,21,Redlichen Primary School,7100GVE2105
66,772,706,84,Guruve,Guruve North,Guruve RDC,23,Kemutamba Primary School,7100GVE2301
32,576,544,89,Guruve,Guruve North,Guruve RDC,23,Mudhindo Primary School,7100GVE2302
21,210,189,81,Guruve,Guruve North,Guruve RDC,23,Mudhindo Village Tent,7100GVE2303
25,578,553,91,Guruve,Guruve South,Guruve RDC,1,Camsasa Clinic Tent A,7100GVE0101 A
25,586,561,91,Guruve,Guruve South,Guruve RDC,1,Camsasa Clinic Tent B,7100GVE0101 B
8,167,159,90,Guruve,Guruve South,Guruve RDC,1,Chengoma Farm Tent,7100GVE0102
16,315,299,90,Guruve,Guruve South,Guruve RDC,1,Horseshoe Primary School,7100GVE0103
37,667,630,89,Guruve,Guruve South,Guruve RDC,1,Manyika Primary School,7100GVE0104
24,631,607,92,Guruve,Guruve South,Guruve RDC,1,Muroyiwa Primary School,7100GVE0105
14,885,871,96,Guruve,Guruve South,Guruve RDC,1,Siyalima Primary School,7100GVE0106
57,734,677,85,Guruve,Guruve South,Guruve RDC,1,Tengenenge Art Centre Tent,7100GVE0107
10,178,168,89,Guruve,Guruve South,Guruve RDC,9,Hozo Business Centre Tent,7100GVE0901
56,542,486,81,Guruve,Guruve South,Guruve RDC,9,Magaya Primary School,7100GVE0903
18,186,168,82,Guruve,Guruve South,Guruve RDC,12,Gracemore Business Centre Tent,7100GVE1203
43,427,384,81,Guruve,Guruve South,Guruve RDC,13,Brandon Primary School,7100GVE1301
24,597,573,92,Guruve,Guruve South,Guruve RDC,13,Kelston 1 Primary School A,7100GVE1302 A
28,578,550,90,Guruve,Guruve South,Guruve RDC,13,Kelston 1 Primary School B,7100GVE1302 B
29,617,588,91,Guruve,Guruve South,Guruve RDC,13,Mswite Farm Tent,7100GVE1303
34,439,405,85,Guruve,Guruve South,Guruve RDC,13,Mt Fatigue Primary School,7100GVE1304
9,649,640,97,Guruve,Guruve South,Guruve RDC,13,Mutendamambo Primary School,7100GVE1305
21,418,397,90,Guruve,Guruve South,Guruve RDC,13,Velvekia Primary School,7100GVE1306
75,721,646,81,Guruve,Guruve South,Guruve RDC,14,Birkdale Primary School,7100GVE1401
13,132,119,82,Guruve,Guruve South,Guruve RDC,14,Chikonyora Farm Tent,7100GVE1402
43,571,528,85,Guruve,Guruve South,Guruve RDC,14,Disi 2 Farm Tent,7100GVE1403
29,277,248,81,Guruve,Guruve South,Guruve RDC,14,Impinge Pre-School Tent,7100GVE1404
17,380,363,91,Guruve,Guruve South,Guruve RDC,15,Chihwe Primary School,7100GVE1501
25,691,666,93,Guruve,Guruve South,Guruve RDC,15,Nyamangore Primary School,7100GVE1502
42,423,381,81,Mazowe,Mazowe North,Mazowe RDC,2,Chigwida Primary School,1500MAZ0202
14,288,274,90,Mazowe,Mazowe North,Mazowe RDC,3,Chideu Primary School,1500MAZ0302
26,466,440,89,Mazowe,Mazowe North,Mazowe RDC,26,Kubatana Primary School A,1500MAZ2601 A
27,452,425,88,Mazowe,Mazowe North,Mazowe RDC,26,Kubatana Primary School B,1500MAZ2601 B
24,451,427,89,Mazowe,Mazowe North,Mazowe RDC,26,Mandindindi Secondary School,1500MAZ2602
48,459,411,81,Mazowe,Mazowe North,Mazowe RDC,26,Sandford Farm Tent,1500MAZ2605
53,753,700,86,Mazowe,Mazowe North,Mazowe RDC,27,Chimurenga 3 Primary School,1500MAZ2701
23,328,305,86,Mazowe,Mazowe North,Mazowe RDC,27,Forrester D Estate,1500MAZ2703
42,581,539,86,Mazowe,Mazowe North,Mazowe RDC,27,Forrester E Primary School,1500MAZ2704
49,683,634,86,Mazowe,Mazowe North,Mazowe RDC,27,Forrester F Primary School,1500MAZ2705
41,498,457,84,Mazowe,Mazowe North,Mazowe RDC,27,Forrester J Primary School,1500MAZ2706
33,529,496,88,Mazowe,Mazowe North,Mazowe RDC,27,Rumanje Farm Primary School,1500MAZ2707
4,285,281,97,Mazowe,Mazowe North,Mazowe RDC,29,Barrock Farm Tent,1500MAZ2901
52,830,778,88,Mazowe,Mazowe North,Mazowe RDC,29,Craiglea Farm Creche,1500MAZ2902
9,275,266,93,Mazowe,Mazowe North,Mazowe RDC,29,Edmonstorn (Suwoguru) Primary School,1500MAZ2904
23,565,542,92,Mazowe,Mazowe North,Mazowe RDC,29,Holland Primary School A,1500MAZ2905 A
27,548,521,90,Mazowe,Mazowe North,Mazowe RDC,29,Holland Primary School B,1500MAZ2905 B
34,334,300,81,Mazowe,Mazowe North,Mazowe RDC,29,Mvurwi Country Club,1500MAZ2906
21,258,237,84,Mazowe,Mazowe South,Mazowe RDC,14,Amelroy Farm Tent,1500MAZ1401
38,526,488,86,Mazowe,Mazowe South,Mazowe RDC,14,Batanai Secondary School,1500MAZ1402
6,306,300,96,Mazowe,Mazowe South,Mazowe RDC,14,Bellrock Stud Farm Tent,1500MAZ1403
9,345,336,94,Mazowe,Mazowe South,Mazowe RDC,14,Davaar Farm Clinic,1500MAZ1404
24,340,316,86,Mazowe,Mazowe South,Mazowe RDC,14,Foothills Primary School,1500MAZ1405
34,376,342,83,Mazowe,Mazowe South,Mazowe RDC,14,Villa Franca Farm Shed Tent,1500MAZ1407
5,355,350,97,Mazowe,Mazowe South,Mazowe RDC,18,Brecon Farm Tent,1500MAZ1801
53,527,474,81,Mazowe,Mazowe South,Mazowe RDC,18,Vonabo Primary School A,1500MAZ1803 A
47,739,692,88,Mazowe,Mazowe South,Mazowe RDC,19,Wagner Mill (Munyoro) Tent,1500MAZ1905
19,227,208,84,Mazowe,Mazowe West,Mazowe RDC,21,Berea Primary School,1500MAZ2102
4,180,176,95,Mazowe,Mazowe West,Mazowe RDC,21,Spa Farm Tent,1500MAZ2107
45,517,472,83,Mazowe,Mazowe West,Mazowe RDC,23,Msasa Primary School,1500MAZ2304
41,429,388,82,Mazowe,Mazowe West,Mazowe RDC,24,Chaddesley Farm Tent,1500MAZ2402
16,259,243,88,Mazowe,Mazowe West,Mazowe RDC,24,Chemutamba Primary School,1500MAZ2403
27,476,449,89,Mazowe,Mazowe West,Mazowe RDC,24,Horta Primary School,1500MAZ2404
40,560,520,86,Mazowe,Mazowe West,Mazowe RDC,25,Copley Primary School,1500MAZ2501
15,297,282,90,Mazowe,Mazowe West,Mazowe RDC,25,Earlyworm Primary School,1500MAZ2502
13,299,286,91,Mazowe,Mazowe West,Mazowe RDC,25,Glenbrook Farm Primary School,1500MAZ2503
44,625,581,86,Mazowe,Mazowe West,Mazowe RDC,25,Maori Range Primary School,1500MAZ2504
47,561,514,84,Mazowe,Mazowe West,Mazowe RDC,25,Nhangura Primary School,1500MAZ2505
16,466,450,93,Mazowe,Mazowe West,Mazowe RDC,25,The Rivers Primary School,1500MAZ2506
26,554,528,91,Mazowe,Mazowe West,Mazowe RDC,30,Farai Primary School A,1500MAZ3001 A
45,513,468,83,Mazowe,Mazowe West,Mazowe RDC,30,Farai Primary School B,1500MAZ3001 B
26,322,296,85,Mazowe,Mazowe West,Mazowe RDC,30,Hariana Primary School,1500MAZ3002
33,725,692,91,Mazowe,Mazowe West,Mazowe RDC,30,Lucknow Primary School,1500MAZ3003
19,329,310,89,Mazowe,Mazowe West,Mazowe RDC,31,Collingwood Farm Creche,1500MAZ3101
28,439,411,88,Mazowe,Mazowe West,Mazowe RDC,31,Cranham Secondary School,1500MAZ3102
14,233,219,88,Mazowe,Mazowe West,Mazowe RDC,31,Howickridge Primary School,1500MAZ3103
32,493,461,87,Mazowe,Mazowe West,Mazowe RDC,31,Ivador Primary School,1500MAZ3104
32,675,643,90,Mazowe,Mazowe West,Mazowe RDC,32,Hermistone Primary School,1500MAZ3202
15,405,390,92,Mazowe,Mazowe West,Mazowe RDC,32,Thorncreek Farm Tent,1500MAZ3203
6,69,63,84,Mazowe,Mazowe West,Mazowe RDC,34,Pentland Farm Tent,1500MAZ3402
30,486,456,88,Mazowe,Mazowe West,Mazowe RDC,34,Tavydale Farm Tent,1500MAZ3403
34,617,583,89,Mazowe,Mazowe West,Mazowe RDC,34,Watakai Primary School,1500MAZ3405
22,502,480,91,Mbire,Mbire,Mbire RDC,4,Kadzi Primary School A,4600MBR0402 A
44,484,440,83,Mbire,Mbire,Mbire RDC,4,Kadzi Primary School B,4600MBR0402 B
32,349,317,83,Mbire,Mbire,Mbire RDC,4,Kapururira Primary School,4600MBR0403
29,603,574,90,Mbire,Mbire,Mbire RDC,5,Chidodo Primary School A,4600MBR0501 A
42,588,546,86,Mbire,Mbire,Mbire RDC,5,Chidodo Primary School B,4600MBR0501 B
1,14,13,86,Mbire,Mbire,Mbire RDC,5,DDF Chidodo Turn Off Tent,4600MBR0502
6,137,131,91,Mbire,Mbire,Mbire RDC,11,Chaukura Village Tent,4600MBR1101
42,587,545,86,Mbire,Mbire,Mbire RDC,13,Kasemberere Primary School,4600MBR1301
35,427,392,84,Mbire,Mbire,Mbire RDC,16,Gunja Village Tent,4600MBR1601
41,536,495,85,Mt Darwin,Mt Darwin East,Pfura RDC,10,Chitumbuko Primary School,4500PFU1002
48,536,488,83,Mt Darwin,Mt Darwin East,Pfura RDC,10,Mangare Primary School A,4500PFU1003 A
19,312,293,88,Mt Darwin,Mt Darwin East,Pfura RDC,11,Hondoyedzomba Village Tent,4500PFU1101
35,438,403,85,Mt Darwin,Mt Darwin East,Pfura RDC,11,Kajokoto Primary School A,4500PFU1102 A
44,424,380,81,Mt Darwin,Mt Darwin East,Pfura RDC,11,Kajokoto Primary School B,4500PFU1102 B
39,632,593,88,Mt Darwin,Mt Darwin East,Pfura RDC,12,Chitsato Primary School,4500PFU1201
53,533,480,81,Mt Darwin,Mt Darwin East,Pfura RDC,15,Chibara Primary School,4500PFU1502
46,767,721,88,Mt Darwin,Mt Darwin East,Pfura RDC,15,Kambamura Primary School,4500PFU1504
14,505,491,94,Mt Darwin,Mt Darwin East,Pfura RDC,37,Chizeza Primary School,4500PFU3702
44,754,710,88,Mt Darwin,Mt Darwin East,Pfura RDC,38,Date Primary School,4500PFU3801
49,667,618,86,Mt Darwin,Mt Darwin East,Pfura RDC,38,Gumbeze Primary School,4500PFU3802
16,214,198,86,Mt Darwin,Mt Darwin East,Pfura RDC,38,Zingori Primary School,4500PFU3803
12,238,226,90,Rushinga,Mt Darwin East,Rushinga RDC,8,Ganganyama Primary School,6100RUS0801
9,286,277,93,Rushinga,Mt Darwin East,Rushinga RDC,8,Jiwa Primary School,6100RUS0802
10,204,194,90,Rushinga,Mt Darwin East,Rushinga RDC,8,Pfara Village Tent,6100RUS0804
3,99,96,94,Rushinga,Mt Darwin East,Rushinga RDC,9,Machiti Primary School,6100RUS0901
33,363,330,83,Rushinga,Mt Darwin East,Rushinga RDC,9,Rutuka Primary School,6100RUS0903
15,211,196,86,Rushinga,Mt Darwin East,Rushinga RDC,10,Bungwe Community Centre,6100RUS1005
4,146,142,94,Rushinga,Mt Darwin East,Rushinga RDC,10,Wara Village Tent,6100RUS1006
23,329,306,86,Rushinga,Mt Darwin East,Rushinga RDC,11,Gwashure Primary School,6100RUS1102
2,143,141,97,Rushinga,Mt Darwin East,Rushinga RDC,11,Mutematsaka Pre-School,6100RUS1103
9,438,429,95,Mt Darwin,Mt Darwin North,Pfura RDC,1,Chimbangu Village Tent,4500PFU0101
18,665,647,94,Mt Darwin,Mt Darwin North,Pfura RDC,2,Chisecha Primary School A,4500PFU0201 A
46,616,570,86,Mt Darwin,Mt Darwin North,Pfura RDC,2,Chisecha Primary School B,4500PFU0201 B
8,374,366,95,Mt Darwin,Mt Darwin North,Pfura RDC,2,Kapfudza Business Centre Tent,4500PFU0203
15,478,463,93,Mt Darwin,Mt Darwin North,Pfura RDC,5,Tsenga Pre-School Tent A,4500PFU0502 A
18,472,454,92,Mt Darwin,Mt Darwin North,Pfura RDC,5,Tsenga Pre-School Tent B,4500PFU0502 B
4,140,136,94,Mt Darwin,Mt Darwin North,Pfura RDC,6,Chaumana Primary School,4500PFU0601
19,566,547,93,Mt Darwin,Mt Darwin North,Pfura RDC,6,Kapanda Primary School,4500PFU0602
37,557,520,87,Mt Darwin,Mt Darwin North,Pfura RDC,6,Mutasa Primary School,4500PFU0603
24,446,422,89,Mt Darwin,Mt Darwin North,Pfura RDC,31,Murongwe Primary School,4500PFU3102
12,524,512,95,Mt Darwin,Mt Darwin North,Pfura RDC,31,Mutasa 3 Pre-School,4500PFU3103
37,459,422,85,Mt Darwin,Mt Darwin North,Pfura RDC,33,Chigango Primary School A,4500PFU3302 A
44,440,396,81,Mt Darwin,Mt Darwin North,Pfura RDC,33,Chigango Primary School B,4500PFU3302 B
24,449,425,89,Mt Darwin,Mt Darwin North,Pfura RDC,33,Gungwa Primary School,4500PFU3303
7,387,380,96,Mt Darwin,Mt Darwin South,Pfura RDC,22,Amanda Village Tent,4500PFU2201
20,333,313,88,Mt Darwin,Mt Darwin South,Pfura RDC,22,Bemberi Primary School,4500PFU2202
18,766,748,95,Mt Darwin,Mt Darwin South,Pfura RDC,22,Chibondo Business Centre Tent,4500PFU2203
37,840,803,91,Mt Darwin,Mt Darwin South,Pfura RDC,22,Chipa Business Centre Tent,4500PFU2204
54,683,629,85,Mt Darwin,Mt Darwin South,Pfura RDC,22,Tangenhamo Secondary School,4500PFU2206
40,476,436,84,Mt Darwin,Mt Darwin South,Pfura RDC,22,Tsakare Community Hall A,4500PFU2207 A
33,481,448,87,Mt Darwin,Mt Darwin South,Pfura RDC,22,Tsakare Community Hall B,4500PFU2207 B
32,558,526,89,Mt Darwin,Mt Darwin South,Pfura RDC,24,Chatumbama Primary School,4500PFU2401
44,532,488,84,Mt Darwin,Mt Darwin South,Pfura RDC,24,Matope Primary School,4500PFU2404
126,7,-119,-89,Mt Darwin,Mt Darwin South,Pfura RDC,24,Mazonde Village Tent,4500PFU2405
45,494,449,83,Mt Darwin,Mt Darwin South,Pfura RDC,27,Chindunduma High School,4500PFU2701
25,538,513,91,Mt Darwin,Mt Darwin South,Pfura RDC,27,Gwetera Pre-School Tent,4500PFU2703
12,551,539,95,Mt Darwin,Mt Darwin South,Pfura RDC,39,Ravine Village Tent A,4500PFU3901 A
22,527,505,91,Mt Darwin,Mt Darwin South,Pfura RDC,39,Ravine Village Tent B,4500PFU3901 B
32,463,431,87,Mt Darwin,Mt Darwin South,Pfura RDC,39,Tsakare Primary School A,4500PFU3902 A
24,454,430,89,Mt Darwin,Mt Darwin South,Pfura RDC,39,Tsakare Primary School B,4500PFU3902 B
33,384,351,84,Mt Darwin,Mt Darwin South,Pfura RDC,40,Chaminuka Training Centre B,4500PFU4001 B
37,610,573,88,Mt Darwin,Mt Darwin South,Pfura RDC,40,Chomagora Primary School A,4500PFU4002 A
35,611,576,89,Mt Darwin,Mt Darwin South,Pfura RDC,40,Chomagora Primary School B,4500PFU4002 B
33,550,517,88,Mt Darwin,Mt Darwin South,Pfura RDC,40,Manhondo Business Centre Tent A,4500PFU4003 A
0,532,532,100,Mt Darwin,Mt Darwin South,Pfura RDC,40,Manhondo Business Centre Tent B,4500PFU4003 B
43,603,560,86,Mt Darwin,Mt Darwin West,Pfura RDC,8,Nohwedza Village Tent,4500PFU0804
17,374,357,91,Mt Darwin,Mt Darwin West,Pfura RDC,17,Kazai Primary School,4500PFU1702
50,548,498,83,Mt Darwin,Mt Darwin West,Pfura RDC,17,Mudzengerere Secondary School A,4500PFU1703 A
47,547,500,84,Mt Darwin,Mt Darwin West,Pfura RDC,17,Mudzengerere Secondary School B,4500PFU1703 B
17,567,550,94,Mt Darwin,Mt Darwin West,Pfura RDC,18,Chakanetsa Primary School,4500PFU1801
18,817,799,95,Mt Darwin,Mt Darwin West,Pfura RDC,18,Mutungagore Primary School,4500PFU1802
32,561,529,89,Mt Darwin,Mt Darwin West,Pfura RDC,18,Mutungagore Secondary School,4500PFU1803
22,443,421,90,Mt Darwin,Mt Darwin West,Pfura RDC,18,Nyamaswau Primary School,4500PFU1804
5,285,280,96,Mt Darwin,Mt Darwin West,Pfura RDC,18,Nyamhara Village Tent,4500PFU1805
4,434,430,98,Mt Darwin,Mt Darwin West,Pfura RDC,19,Binga Primary School,4500PFU1901
40,688,648,89,Mt Darwin,Mt Darwin West,Pfura RDC,19,Chibuli Primary School,4500PFU1902
16,250,234,87,Mt Darwin,Mt Darwin West,Pfura RDC,19,Chitepo A Village Tent,4500PFU1903
41,456,415,83,Mt Darwin,Mt Darwin West,Pfura RDC,19,Dolphin Park Primary School,4500PFU1904
1,150,149,98,Mt Darwin,Mt Darwin West,Pfura RDC,19,Glassalla Village,4500PFU1905
1,460,459,99,Mt Darwin,Mt Darwin West,Pfura RDC,19,Mutwa Estate Tent,4500PFU1906
17,466,449,92,Mt Darwin,Mt Darwin West,Pfura RDC,19,Newveld/Mudzinge Church Hall,4500PFU1907
2,235,233,98,Mt Darwin,Mt Darwin West,Pfura RDC,19,Nyamaridza Village Tent,4500PFU1908
19,219,200,84,Mt Darwin,Mt Darwin West,Pfura RDC,19,Panorama Training Centre,4500PFU1909
3,237,234,97,Mt Darwin,Mt Darwin West,Pfura RDC,19,Tongogara Village Tent,4500PFU1910
7,586,579,97,Mt Darwin,Mt Darwin West,Pfura RDC,20,Kuyedza Village Tent,4500PFU2002
16,479,463,93,Mt Darwin,Mt Darwin West,Pfura RDC,20,Mutwa Primary School,4500PFU2003
16,248,232,87,Mt Darwin,Mt Darwin West,Pfura RDC,20,Mutwa Secondary School,4500PFU2004
23,464,441,90,Mt Darwin,Mt Darwin West,Pfura RDC,20,Tsamvi Primary School,4500PFU2005
11,254,243,91,Mt Darwin,Mt Darwin West,Pfura RDC,35,Forty Misery Business Centre Tent,4500PFU3502
49,546,497,83,Mt Darwin,Mt Darwin West,Pfura RDC,36,Karaga Village Tent,4500PFU3604
37,404,367,83,Muzarabani,Muzarabani North,Muzarabani RDC,1,Chadereka Primary School,1100MUZ0101
11,164,153,87,Muzarabani,Muzarabani North,Muzarabani RDC,1,Chadereka Secondary School,1100MUZ0102
40,405,365,82,Muzarabani,Muzarabani North,Muzarabani RDC,1,Chimoio Primary School,1100MUZ0103
17,458,441,92,Muzarabani,Muzarabani North,Muzarabani RDC,1,Gunduza Primary School,1100MUZ0104
12,187,175,87,Muzarabani,Muzarabani North,Muzarabani RDC,1,Kanyaya Village Tent,1100MUZ0105
33,381,348,84,Muzarabani,Muzarabani North,Muzarabani RDC,1,Musingwa Primary School,1100MUZ0106
19,259,240,86,Muzarabani,Muzarabani North,Muzarabani RDC,1,Sone Primary School,1100MUZ0107
15,545,530,94,Muzarabani,Muzarabani North,Muzarabani RDC,2,Chiridza Primary School,1100MUZ0201
53,574,521,83,Muzarabani,Muzarabani North,Muzarabani RDC,2,Gumbochuma Primary School,1100MUZ0202
15,428,413,93,Muzarabani,Muzarabani North,Muzarabani RDC,2,Guni Village Tent,1100MUZ0203
11,297,286,92,Muzarabani,Muzarabani North,Muzarabani RDC,3,Chirimbwa Village Tent,1100MUZ0302
37,511,474,86,Muzarabani,Muzarabani North,Muzarabani RDC,4,Dambakurima Primary School,1100MUZ0402
2,98,96,96,Muzarabani,Muzarabani North,Muzarabani RDC,7,Muganhi Village Tent,1100MUZ0702
18,192,174,82,Muzarabani,Muzarabani North,Muzarabani RDC,8,Muringazuva Village Tent,1100MUZ0802
14,322,308,91,Muzarabani,Muzarabani North,Muzarabani RDC,8,Mushinye Village Tent,1100MUZ0803
2,117,115,96,Muzarabani,Muzarabani North,Muzarabani RDC,19,Tandare Village Tent,1100MUZ1902
17,437,420,92,Muzarabani,Muzarabani North,Muzarabani RDC,23,Kaerezi Primary School A,1100MUZ2302 A
33,434,401,85,Muzarabani,Muzarabani North,Muzarabani RDC,23,Kaerezi Primary School B,1100MUZ2302 B
13,308,295,91,Muzarabani,Muzarabani North,Muzarabani RDC,23,Kakonono Village Tent,1100MUZ2303
52,515,463,81,Muzarabani,Muzarabani North,Muzarabani RDC,24,Chibombo Primary School,1100MUZ2401
27,757,730,93,Muzarabani,Muzarabani North,Muzarabani RDC,24,Chiwenga Primary School,1100MUZ2402
33,646,613,90,Muzarabani,Muzarabani North,Muzarabani RDC,24,Keche Primary School,1100MUZ2403
32,380,348,84,Muzarabani,Muzarabani North,Muzarabani RDC,24,Machakwa Village Tent,1100MUZ2404
29,675,646,91,Muzarabani,Muzarabani North,Muzarabani RDC,27,Museredza Primary School,1100MUZ2702
21,606,585,93,Muzarabani,Muzarabani South,Muzarabani RDC,9,Chiwashira Primary School,1100MUZ0901
42,469,427,83,Muzarabani,Muzarabani South,Muzarabani RDC,9,Mhene Primary School,1100MUZ0902
12,480,468,95,Muzarabani,Muzarabani South,Muzarabani RDC,10,Uchachacha DDF Rest Camp Tent,1100MUZ1003
37,418,381,83,Muzarabani,Muzarabani South,Muzarabani RDC,11,Chiripiro Primary School,1100MUZ1101
42,451,409,82,Muzarabani,Muzarabani South,Muzarabani RDC,11,Munhenga Primary School A,1100MUZ1102 A
32,445,413,86,Muzarabani,Muzarabani South,Muzarabani RDC,11,Munhenga Primary School B,1100MUZ1102 B
19,506,487,92,Muzarabani,Muzarabani South,Muzarabani RDC,12,Chikale Farm Tent,1100MUZ1201
9,268,259,93,Muzarabani,Muzarabani South,Muzarabani RDC,12,Hilbree Primary School,1100MUZ1202
21,433,412,90,Muzarabani,Muzarabani South,Muzarabani RDC,12,Samanyanga Primary School,1100MUZ1203
20,432,412,91,Muzarabani,Muzarabani South,Muzarabani RDC,12,Trinity Rock farm Tent,1100MUZ1204
13,179,166,86,Muzarabani,Muzarabani South,Muzarabani RDC,13,Kilkerran Farm Tent,1100MUZ1302
21,433,412,90,Muzarabani,Muzarabani South,Muzarabani RDC,13,Maware Primary School,1100MUZ1303
25,331,306,85,Muzarabani,Muzarabani South,Muzarabani RDC,13,Silverstroom Primary School,1100MUZ1304
36,729,693,90,Muzarabani,Muzarabani South,Muzarabani RDC,14,Ashford Primary School,1100MUZ1401
35,813,778,91,Muzarabani,Muzarabani South,Muzarabani RDC,14,Clearmorning Primary School,1100MUZ1403
7,599,592,97,Muzarabani,Muzarabani South,Muzarabani RDC,14,Goromokwa Primary School,1100MUZ1404
14,192,178,86,Muzarabani,Muzarabani South,Muzarabani RDC,14,Mwonga farm - Tent,1100MUZ1405
9,163,154,89,Muzarabani,Muzarabani South,Muzarabani RDC,14,Tekwani Farm Tent,1100MUZ1406
26,339,313,85,Muzarabani,Muzarabani South,Muzarabani RDC,17,Charunda Primary School,1100MUZ1701
24,657,633,92,Muzarabani,Muzarabani South,Muzarabani RDC,17,Hoya Primary School,1100MUZ1702
6,465,459,97,Muzarabani,Muzarabani South,Muzarabani RDC,17,Kambudzi Primary School,1100MUZ1703
11,330,319,93,Muzarabani,Muzarabani South,Muzarabani RDC,17,Mangurenje Primary School,1100MUZ1704
0,13,13,100,Muzarabani,Muzarabani South,Muzarabani RDC,18,Mufuka Village Tent,1100MUZ1801
7,321,314,95,Muzarabani,Muzarabani South,Muzarabani RDC,18,Murimo Business Centre Tent,1100MUZ1802
18,485,467,92,Muzarabani,Muzarabani South,Muzarabani RDC,18,Mutemakungu Primary School,1100MUZ1803
47,458,411,81,Muzarabani,Muzarabani South,Muzarabani RDC,20,Chawarura Primary School A,1100MUZ2001 A
29,303,274,82,Muzarabani,Muzarabani South,Muzarabani RDC,21,Chawarura Skills Development Centre,1100MUZ2101
18,373,355,90,Muzarabani,Muzarabani South,Muzarabani RDC,21,Chitemamuswe Primary School,1100MUZ2102
3,152,149,96,Muzarabani,Muzarabani South,Muzarabani RDC,21,Mavhuradonha Farm Tent,1100MUZ2103
67,687,620,82,Muzarabani,Muzarabani South,Muzarabani RDC,22,Chaona Resettlement Tent,1100MUZ2201
14,374,360,92,Muzarabani,Muzarabani South,Muzarabani RDC,25,The Range Farm Tent,1100MUZ2501
38,636,598,88,Muzarabani,Muzarabani South,Muzarabani RDC,25,Westbury Farm Tent,1100MUZ2502
14,359,345,92,Muzarabani,Muzarabani South,Muzarabani RDC,26,Dunbarton Farm Tent,1100MUZ2601
22,656,634,93,Muzarabani,Muzarabani South,Muzarabani RDC,26,Takunda Primary School A,1100MUZ2602 A
39,628,589,88,Muzarabani,Muzarabani South,Muzarabani RDC,26,Takunda Primary School B,1100MUZ2602 B
15,518,503,94,Muzarabani,Muzarabani South,Muzarabani RDC,28,Aranbira Primary School,1100MUZ2801
29,752,723,92,Muzarabani,Muzarabani South,Muzarabani RDC,28,Chidikamwedzi Primary School,1100MUZ2802
5,175,170,94,Muzarabani,Muzarabani South,Muzarabani RDC,28,Chipata Primary School,1100MUZ2803
31,378,347,84,Muzarabani,Muzarabani South,Muzarabani RDC,28,Mutorazeni Farm Tent,1100MUZ2804
8,356,348,95,Muzarabani,Muzarabani South,Muzarabani RDC,28,Sulugulu Farm Tent,1100MUZ2805
7,361,354,96,Muzarabani,Muzarabani South,Muzarabani RDC,29,Aurellia Farm Tent,1100MUZ2901
6,704,698,98,Muzarabani,Muzarabani South,Muzarabani RDC,29,Minda Primary School,1100MUZ2902
2,231,229,98,Muzarabani,Muzarabani South,Muzarabani RDC,29,Ruindi Farm Tent,1100MUZ2903
9,247,238,92,Rushinga,Rushinga,Rushinga RDC,1,Chabooka Village Tent,6100RUS0101
22,539,517,92,Rushinga,Rushinga,Rushinga RDC,1,Mukosa Primary School,6100RUS0102
18,278,260,87,Rushinga,Rushinga,Rushinga RDC,1,Nyabawa Primary School,6100RUS0103
23,313,290,86,Rushinga,Rushinga,Rushinga RDC,2,Nyamuzeya Primary School,6100RUS0203
21,302,281,86,Rushinga,Rushinga,Rushinga RDC,3,Chimandau Primary School,6100RUS0301
31,480,449,87,Rushinga,Rushinga,Rushinga RDC,3,Chitange Primary School,6100RUS0302
19,274,255,87,Rushinga,Rushinga,Rushinga RDC,3,Machirinje Primary School,6100RUS0303
22,338,316,87,Rushinga,Rushinga,Rushinga RDC,5,Makuni Secondary School,6100RUS0502
20,397,377,90,Rushinga,Rushinga,Rushinga RDC,5,Mukonde Primary School,6100RUS0503
10,395,385,95,Rushinga,Rushinga,Rushinga RDC,6,Kasenzi Business Centre Tent,6100RUS0601
2,153,151,97,Rushinga,Rushinga,Rushinga RDC,6,Nyabvedzi Village Tent,6100RUS0603
7,69,62,81,Rushinga,Rushinga,Rushinga RDC,6,Nyanhoto Village Tent,6100RUS0604
18,262,244,87,Rushinga,Rushinga,Rushinga RDC,7,Chitepo Primary School,6100RUS0701
6,123,117,90,Rushinga,Rushinga,Rushinga RDC,7,Kanzara Pre-School,6100RUS0703
29,329,300,83,Rushinga,Rushinga,Rushinga RDC,7,Mandendera Business Centre Tent,6100RUS0704
11,128,117,84,Rushinga,Rushinga,Rushinga RDC,14,Harumbwi Village Tent,6100RUS1403
2,127,125,96,Rushinga,Rushinga,Rushinga RDC,16,Betty Village Tent,6100RUS1601
5,182,177,94,Rushinga,Rushinga,Rushinga RDC,16,Chaparadza Village Tent,6100RUS1603
36,419,383,84,Rushinga,Rushinga,Rushinga RDC,16,Huruma Primary School,6100RUS1604
5,114,109,91,Rushinga,Rushinga,Rushinga RDC,17,Chinaka Pre-School,6100RUS1701
7,305,298,95,Rushinga,Rushinga,Rushinga RDC,17,Mudzikatiri Village Tent,6100RUS1703
36,560,524,87,Rushinga,Rushinga,Rushinga RDC,18,Kamanika Primary School,6100RUS1801
4,234,230,96,Rushinga,Rushinga,Rushinga RDC,18,Kararira ECD Centre,6100RUS1802
2,187,185,97,Rushinga,Rushinga,Rushinga RDC,18,Karige ECD Centre,6100RUS1803
6,98,92,88,Rushinga,Rushinga,Rushinga RDC,18,Tungwengwe Village Tent,6100RUS1806
11,191,180,89,Rushinga,Rushinga,Rushinga RDC,19,Chiromba Primary School,6100RUS1901
9,357,348,95,Rushinga,Rushinga,Rushinga RDC,20,Murehwa Village Tent,6100RUS2002
1,68,67,97,Rushinga,Rushinga,Rushinga RDC,21,Chipwere Village Tent,6100RUS2101
19,260,241,86,Rushinga,Rushinga,Rushinga RDC,21,Mazengera Village Tent,6100RUS2102
5,199,194,95,Rushinga,Rushinga,Rushinga RDC,22,Jangwa Village Tent,6100RUS2202
7,136,129,90,Rushinga,Rushinga,Rushinga RDC,22,Karombe Village Tent,6100RUS2203
5,201,196,95,Rushinga,Rushinga,Rushinga RDC,22,Matoto Primary School,6100RUS2205
18,369,351,90,Rushinga,Rushinga,Rushinga RDC,23,Mushongahande Village Tent,6100RUS2303
8,255,247,93,Rushinga,Rushinga,Rushinga RDC,25,Nyamasanga Pre-School,6100RUS2502
9,206,197,91,Shamva,Shamva North,Chaminuka RDC,3,Chizanga Village Tent,6800CHA0301
23,235,212,82,Shamva,Shamva North,Chaminuka RDC,8,Hore Business Centre Tent,6800CHA0801
33,393,360,84,Shamva,Shamva North,Chaminuka RDC,10,Gora Business Centre Tent,6800CHA1003
5,449,444,97,Shamva,Shamva North,Chaminuka RDC,14,Magadzi Primary School A,6800CHA1401 A
9,432,423,95,Shamva,Shamva North,Chaminuka RDC,14,Magadzi Primary School B,6800CHA1401 B
21,305,284,87,Shamva,Shamva North,Chaminuka RDC,14,Zvomanyanga Primary School,6800CHA1402
10,546,536,96,Shamva,Shamva North,Chaminuka RDC,14,Mukwari Primary School,6800CHA1403
25,622,597,92,Shamva,Shamva North,Chaminuka RDC,14,Simba Village Tent,6800CHA1405
38,512,474,86,Shamva,Shamva North,Chaminuka RDC,14,Ponesai Vanhu Technical College,6800CHA1406
32,408,376,85,Shamva,Shamva North,Chaminuka RDC,16,Mudzinge Primary School,6800CHA1601
48,817,769,88,Shamva,Shamva North,Chaminuka RDC,16,Batsiranai Primary School,6800CHA1603
23,413,390,89,Shamva,Shamva North,Chaminuka RDC,16,Muringamombe Primary School,6800CHA1604
25,284,259,83,Shamva,Shamva South,Chaminuka RDC,11,Gono Secondary School,6800CHA1103
11,399,388,94,Shamva,Shamva South,Chaminuka RDC,12,Nanaza Village Tent,6800CHA1202
49,588,539,84,Shamva,Shamva South,Chaminuka RDC,12,Sindura Village Tent,6800CHA1203
51,752,701,87,Shamva,Shamva South,Chaminuka RDC,13,Chishapa Primary School,6800CHA1302
39,813,774,90,Shamva,Shamva South,Chaminuka RDC,15,Chevakadzi Primary School,6800CHA1501
8,189,181,91,Shamva,Shamva South,Chaminuka RDC,15,Chemhondoro Primary School,6800CHA1502
12,466,454,94,Shamva,Shamva South,Chaminuka RDC,15,Utsig Lot 10 Village Tent,6800CHA1503
17,574,557,94,Shamva,Shamva South,Chaminuka RDC,15,Chemhanza Primary School,6800CHA1504
27,558,531,90,Shamva,Shamva South,Chaminuka RDC,15,Chidumbwe Hall,6800CHA1505
17,564,547,94,Shamva,Shamva South,Chaminuka RDC,17,Mugagau Village Tent,6800CHA1701
27,526,499,90,Shamva,Shamva South,Chaminuka RDC,17,Nyamahumbe Primary School,6800CHA1702
36,741,705,90,Shamva,Shamva South,Chaminuka RDC,17,Pfumvuti Primary School,6800CHA1703
27,875,848,94,Shamva,Shamva South,Chaminuka RDC,17,Rustington Primary School,6800CHA1704
6,483,477,97,Shamva,Shamva South,Chaminuka RDC,17,Muuyu Business CentreTent,6800CHA1705
12,575,563,95,Shamva,Shamva South,Chaminuka RDC,18,Golden Star Resettlement Tent,6800CHA1801
27,361,334,86,Shamva,Shamva South,Chaminuka RDC,18,Pote Store Tent,6800CHA1802
15,273,258,89,Shamva,Shamva South,Chaminuka RDC,18,Soma Primary School,6800CHA1803
9,417,408,95,Shamva,Shamva South,Chaminuka RDC,19,Mandimu Primary School,6800CHA1901
24,262,238,83,Shamva,Shamva South,Chaminuka RDC,19,Nherera Primary School,6800CHA1902
8,250,242,93,Shamva,Shamva South,Chaminuka RDC,19,Musau Primary School,6800CHA1903
16,709,693,95,Shamva,Shamva South,Chaminuka RDC,19,Mont Dor Mine Tent,6800CHA1904
15,554,539,94,Shamva,Shamva South,Chaminuka RDC,19,Shamva Mining Centre Hall,6800CHA1905
42,850,808,90,Shamva,Shamva South,Chaminuka RDC,20,Mushambanyama Primary School,6800CHA2002
9,262,253,93,Shamva,Shamva South,Chaminuka RDC,20,Carries Rest Tent,6800CHA2003
14,346,332,92,Shamva,Shamva South,Chaminuka RDC,20,Tafuna Hills Tent,6800CHA2004
23,396,373,89,Shamva,Shamva South,Chaminuka RDC,20,Chiraramo Primary School,6800CHA2005
14,336,322,92,Shamva,Shamva South,Chaminuka RDC,21,Bythorn ECD Centre,6800CHA2101
14,321,307,91,Shamva,Shamva South,Chaminuka RDC,21,Nyamadombo Resettlement Tent,6800CHA2102
9,477,468,96,Shamva,Shamva South,Chaminuka RDC,21,Karara Primary School,6800CHA2104
30,395,365,85,Shamva,Shamva South,Chaminuka RDC,23,Shamva LDV Primary School,6800CHA2302
39,398,359,82,Shamva,Shamva South,Chaminuka RDC,27,Mashambe Primary School,6800CHA2701
30,858,828,93,Shamva,Shamva South,Chaminuka RDC,27,Sanye Primary School,6800CHA2702
23,669,646,93,Shamva,Shamva South,Chaminuka RDC,27,Principe Irrigation Hall,6800CHA2703
35,474,439,86,Shamva,Shamva South,Chaminuka RDC,28,Gapara Business Centre Tent,6800CHA2802
31,528,497,88,Shamva,Shamva South,Chaminuka RDC,29,Richlands Farm Magobo Tent,6800CHA2904
152,14,-138,-83,Binga,Binga North,Binga RDC,2,Nakasako Primary School,0600BGA0203
352,23,-329,-87,Binga,Binga North,Binga RDC,4,Sinansengwe Primary School,0600BGA0404
499,24,-475,-90,Binga,Binga North,Binga RDC,6,Damba Primary School,0600BGA0601
409,28,-381,-87,Binga,Binga North,Binga RDC,6,Manjolo High School,0600BGA0602
551,49,-502,-83,Binga,Binga North,Binga RDC,6,Masibinta Secondary School,0600BGA0603
325,22,-303,-87,Binga,Binga North,Binga RDC,6,Musenampongo Primary School,0600BGA0604
454,40,-414,-83,Binga,Binga South,Binga RDC,14,Mulindi Primary School,0600BGA1404
432,28,-404,-87,Binga,Binga South,Binga RDC,15,Manseme Primary School,0600BGA1502
321,27,-294,-84,Binga,Binga South,Binga RDC,16,Muunde Primary School,0600BGA1606
445,22,-423,-90,Binga,Binga South,Binga RDC,20,Lubimbi Business Centre Tent,0600BGA2005
109,11,-98,-81,Binga,Binga South,Binga RDC,25,Katete Primary School,0600BGA2502
10,191,181,90,Bubi,Bubi,Bubi RDC,1,Abantukuqala Tent,3500BUB0101
15,238,223,88,Bubi,Bubi,Bubi RDC,1,Enaleni Primary School,3500BUB0103
18,388,370,91,Bubi,Bubi,Bubi RDC,1,Makhosini Primary School,3500BUB0105
4,55,51,86,Bubi,Bubi,Bubi RDC,3,Molo Wejiwa Primary School,3500BUB0304
13,145,132,83,Bubi,Bubi,Bubi RDC,10,Tshayile Primary School,3500BUB1003
8,320,312,95,Bubi,Bubi,Bubi RDC,20,Goodwood Magetsini Store Tent,3500BUB2001
15,221,206,87,Bubi,Bubi,Bubi RDC,20,Pengwani Primary School,3500BUB2004
9,172,163,90,Bubi,Bubi,Bubi RDC,20,Thuthukani Primary School,3500BUB2005
5,243,238,95,Bubi,Bubi,Bubi RDC,20,Zamani Primary School,3500BUB2006
9,215,206,91,Bubi,Bubi,Bubi RDC,21,Bubi Mine Tent,3500BUB2102
13,193,180,87,Bubi,Bubi,Bubi RDC,21,Dollar Block Tent,3500BUB2103
5,203,198,95,Bubi,Bubi,Bubi RDC,21,Ehlathini Farm Tent,3500BUB2104
7,410,403,96,Bubi,Bubi,Bubi RDC,21,Emhlabathini Primary School,3500BUB2105
20,415,395,90,Bubi,Bubi,Bubi RDC,21,Thame Primary School,3500BUB2107
27,270,243,81,Umguza,Bubi,Umguza RDC,10,Dundubala Primary School,8400UMG1002
612,57,-555,-82,Hwange,Hwange Central,Hwange Local Board,9,Old Stadium Ground Tent C,7901HLB0901 C
641,62,-579,-82,Hwange,Hwange Central,Hwange Local Board,11,Sir Humphrey Gibbs Primary School A,7901HLB1101 A
607,50,-557,-84,Hwange,Hwange Central,Hwange Local Board,20,St Mary's Primary School,7900HWA2003
186,7,-179,-92,Hwange,Hwange East,Hwange RDC,10,Nkandembwe Primary School,7900HWA1006
158,16,-142,-81,Hwange,Hwange East,Hwange RDC,11,Vunda Feeding Scheme Shed Tent,7900HWA1106
381,26,-355,-87,Hwange,Hwange East,Hwange RDC,14,Lambo Primary School,7900HWA1402
318,29,-289,-83,Binga,Binga South,Binga RDC,18,Simbala Primary School,0600BGA1804
30,365,335,84,Hwange,Hwange West,Hwange RDC,1,Matetsi Primary School,7900HWA0103
7,176,169,92,Hwange,Hwange West,Hwange RDC,1,Masuwe Primary School,7900HWA0104
9,126,117,86,Hwange,Hwange West,Hwange RDC,1,Sikabelo Resettlement Farm House,7900HWA0106
4,140,136,94,Lupane,Lupane West,Kusile RDC,24,Mqabuko Grounds Tent,4100KUS2404
12,115,103,81,Nkayi,Nkayi North,Nkayi RDC,9,Maphetshwane Borehole Tent,5300NKY0902
11,109,98,81,Tsholotsho,Tsholotsho South,Tsholotsho RDC,14,Lulwane Line Tent,7300TSH1402
5,82,77,88,Tsholotsho,Tsholotsho South,Tsholotsho RDC,14,Madabu Primary School,7300TSH1403
18,204,186,83,Tsholotsho,Tsholotsho South,Tsholotsho RDC,18,Nkunzi RG Sub-Office Tent,7300TSH1802
4,185,181,95,Tsholotsho,Tsholotsho South,Tsholotsho RDC,18,Thabayi Dip Tank Tent,7300TSH1803
3,42,39,86,Tsholotsho,Tsholotsho South,Tsholotsho RDC,20,Horton Primary School,7300TSH2001
3,166,163,96,Tsholotsho,Tsholotsho South,Tsholotsho RDC,20,Lushabe Primary School,7300TSH2002
5,109,104,91,Tsholotsho,Tsholotsho South,Tsholotsho RDC,20,Segewick Farm Tent,7300TSH2003
19,230,211,84,Tsholotsho,Tsholotsho South,Tsholotsho RDC,20,Sydney Malunga Primary School,7300TSH2004
19,284,265,87,Umguza,Umguza,Umguza RDC,9,Nganzimbi Primary School Tent,8400UMG0904
27,285,258,82,Umguza,Umguza,Umguza RDC,13,Magwadini,8400UMG1301
12,149,137,85,Umguza,Umguza,Umguza RDC,13,Seafield Valley Tent,8400UMG1303
7,89,82,85,Umguza,Umguza,Umguza RDC,14,Bantu Primary School Tent,8400UMG1402
14,177,163,85,Umguza,Umguza,Umguza RDC,14,Carlsvale Tent,8400UMG1403
11,127,116,84,Umguza,Umguza,Umguza RDC,14,Lonsdale Primary School Tent,8400UMG1407
12,188,176,88,Umguza,Umguza,Umguza RDC,14,Muntu Primary School,8400UMG1408
20,193,173,81,Umguza,Umguza,Umguza RDC,14,Redbank Primary School,8400UMG1409
43,475,432,83,Umguza,Umguza,Umguza RDC,19,Nganda Primary School,8400UMG1906
0,8,8,100,Bikita,Bikita East,Bikita RDC,27,Gunundwi Compound Hall,0400BKT2702
0,6,6,100,Bikita,Bikita East,Bikita RDC,27,Savuli Compound Hall,0400BKT2707
26,377,351,87,Chiredzi,Chiredzi East,Chiredzi RDC,6,Makosiya Primary School,1400CHR0603
17,264,247,87,Chiredzi,Chiredzi East,Chiredzi RDC,8,Chehondo Primary School,1400CHR0802
41,731,690,89,Chiredzi,Chiredzi East,Chiredzi RDC,9,Machindu Primary School,1400CHR0903
14,470,456,94,Chiredzi,Chiredzi East,Chiredzi RDC,22,Bilingwe Primary School Tent,1400CHR2202
4,77,73,90,Chiredzi,Chiredzi East,Chiredzi RDC,22,Chitezana Primary School,1400CHR2204
0,4,4,100,Chiredzi,Chiredzi East,Chiredzi RDC,22,Mabalauta Camp Shed,1400CHR2205
2,100,98,96,Chiredzi,Chiredzi North,Chiredzi RDC,1,Maporoma Pre-School,1400CHR0102
7,152,145,91,Chiredzi,Chiredzi North,Chiredzi RDC,1,Tagurana Pre-School,1400CHR0103
31,335,304,83,Chiredzi,Chiredzi North,Chiredzi RDC,2,Mutapurwa Primary School,1400CHR0202
8,135,127,88,Chiredzi,Chiredzi North,Chiredzi RDC,2,Ndari Pre-School,1400CHR0203
11,255,244,91,Chiredzi,Chiredzi North,Chiredzi RDC,16,Banga Primary School,1400CHR1601
21,512,491,92,Chiredzi,Chiredzi North,Chiredzi RDC,16,Basi Primary School,1400CHR1602
32,530,498,88,Chiredzi,Chiredzi North,Chiredzi RDC,16,Bhomba Primary School,1400CHR1603
16,671,655,95,Chiredzi,Chiredzi North,Chiredzi RDC,16,Chahoba Primary School,1400CHR1604
17,745,728,95,Chiredzi,Chiredzi North,Chiredzi RDC,16,Chipabwe Primary School,1400CHR1605
20,297,277,87,Chiredzi,Chiredzi North,Chiredzi RDC,16,Gwerima Primary School,1400CHR1606
25,275,250,83,Chiredzi,Chiredzi North,Chiredzi RDC,16,Mac Kushinga Primary School,1400CHR1607
19,306,287,88,Chiredzi,Chiredzi North,Chiredzi RDC,16,Magudu Ranch Tent,1400CHR1608
17,768,751,95,Chiredzi,Chiredzi North,Chiredzi RDC,16,Manhekwe Primary School,1400CHR1609
36,481,445,86,Chiredzi,Chiredzi North,Chiredzi RDC,16,Masimbiti Primary School A,1400CHR1610 A
39,472,433,84,Chiredzi,Chiredzi North,Chiredzi RDC,16,Masimbiti Primary School B,1400CHR1610 B
2,185,183,97,Chiredzi,Chiredzi North,Chiredzi RDC,16,Mawiro Primary School,1400CHR1611
11,420,409,94,Chiredzi,Chiredzi North,Chiredzi RDC,16,Tashinga Primary School,1400CHR1612
50,707,657,86,Chiredzi,Chiredzi North,Chiredzi RDC,16,Uswaushava Primary School,1400CHR1613
5,229,224,95,Chiredzi,Chiredzi North,Chiredzi RDC,16,Zvouronge Primary School,1400CHR1614
6,445,439,97,Chiredzi,Chiredzi North,Chiredzi RDC,17,Bangala Primary School A,1400CHR1701 A
4,461,457,98,Chiredzi,Chiredzi North,Chiredzi RDC,17,Bangala Primary School B,1400CHR1701 B
24,491,467,90,Chiredzi,Chiredzi North,Chiredzi RDC,17,Crown Ranch Secondary School,1400CHR1702
24,414,390,89,Chiredzi,Chiredzi North,Chiredzi RDC,17,Kushinga Primary School,1400CHR1703
22,581,559,92,Chiredzi,Chiredzi North,Chiredzi RDC,17,Mapfupaamuka Primary School,1400CHR1704
28,573,545,90,Chiredzi,Chiredzi North,Chiredzi RDC,17,Masimbaavanhu Primary School A,1400CHR1705 A
20,592,572,93,Chiredzi,Chiredzi North,Chiredzi RDC,17,Masimbaavanhu Primary School B,1400CHR1705 B
33,544,511,88,Chiredzi,Chiredzi North,Chiredzi RDC,17,Nyabongwe Primary School,1400CHR1706
19,514,495,92,Chiredzi,Chiredzi North,Chiredzi RDC,17,Romwe Primary School,1400CHR1707
29,477,448,88,Chiredzi,Chiredzi North,Chiredzi RDC,17,Samba Secondary School,1400CHR1708
15,249,234,88,Chiredzi,Chiredzi North,Chiredzi RDC,17,Tagarika Primary School,1400CHR1709
40,736,696,89,Chiredzi,Chiredzi North,Chiredzi RDC,17,Zvamagamba Secondary School,1400CHR1710
17,650,633,94,Chiredzi,Chiredzi North,Chiredzi RDC,20,Chikwirire Secondary School,1400CHR2001
24,826,802,94,Chiredzi,Chiredzi North,Chiredzi RDC,20,Judea A Primary School,1400CHR2003
5,352,347,97,Chiredzi,Chiredzi North,Chiredzi RDC,20,Judea B Primary School,1400CHR2004
29,589,560,90,Chiredzi,Chiredzi North,Chiredzi RDC,20,Ngwana Primary School,1400CHR2005
18,536,518,93,Chiredzi,Chiredzi North,Chiredzi RDC,20,Ruware Primary School A,1400CHR2006 A
10,546,536,96,Chiredzi,Chiredzi North,Chiredzi RDC,20,Ruware Primary School B,1400CHR2006 B
29,502,473,89,Chiredzi,Chiredzi North,Chiredzi RDC,20,Sebanani Primary School,1400CHR2007
30,472,442,88,Chiredzi,Chiredzi North,Chiredzi RDC,20,ZINWA Main Camp Hall A,1400CHR2008 A
24,473,449,90,Chiredzi,Chiredzi North,Chiredzi RDC,20,ZINWA Main Camp Hall B,1400CHR2008 B
41,512,471,85,Chiredzi,Chiredzi North,Chiredzi RDC,23,Nyangambe Secondary School,1400CHR2302
36,443,407,84,Chiredzi,Chiredzi North,Chiredzi RDC,23,Nyangambe Primary School,1400CHR2303
12,383,371,93,Chiredzi,Chiredzi North,Chiredzi RDC,24,Chegwite Primary School,1400CHR2401
7,360,353,96,Chiredzi,Chiredzi North,Chiredzi RDC,24,Chibepero Primary School,1400CHR2402
43,713,670,88,Chiredzi,Chiredzi North,Chiredzi RDC,24,Chigonono Primary School,1400CHR2403
23,463,440,90,Chiredzi,Chiredzi North,Chiredzi RDC,24,Gudo Primary School,1400CHR2404
28,530,502,89,Chiredzi,Chiredzi North,Chiredzi RDC,24,Jerezi Secondary School,1400CHR2406
6,389,383,96,Chiredzi,Chiredzi North,Chiredzi RDC,24,Levanga Mbaraidzo Primary School,1400CHR2407
19,518,499,92,Chiredzi,Chiredzi North,Chiredzi RDC,24,Manhenga Primary School,1400CHR2408
33,414,381,85,Chiredzi,Chiredzi North,Chiredzi RDC,24,Matedzi 'A' Primary School A,1400CHR2409 A
27,436,409,88,Chiredzi,Chiredzi North,Chiredzi RDC,24,Matedzi 'A' Primary School B,1400CHR2409 B
31,491,460,88,Chiredzi,Chiredzi North,Chiredzi RDC,24,Matedzi 'B' Primary School,1400CHR2410
47,492,445,82,Chiredzi,Chiredzi North,Chiredzi RDC,24,Mukazi Primary School B,1400CHR2411 B
3,191,188,96,Chiredzi,Chiredzi North,Chiredzi RDC,24,Sungubvi Primary School,1400CHR2413
10,434,424,95,Chiredzi,Chiredzi North,Chiredzi RDC,26,Mungwezi Primary School,1400CHR2601
38,798,760,90,Chiredzi,Chiredzi North,Chiredzi RDC,26,Takunda Primary School,1400CHR2602
46,443,397,81,Chiredzi,Chiredzi North,Chiredzi RDC,29,Kubatana Primary School,1400CHR2903
42,476,434,83,Chiredzi,Chiredzi North,Chiredzi RDC,32,Magumira Primary School,1400CHR3201
44,495,451,83,Chiredzi,Chiredzi North,Chiredzi RDC,32,Nyavasikana Primary School,1400CHR3205
15,258,243,89,Chiredzi,Chiredzi North,Chiredzi RDC,32,Shilo Farm Workshop Shed,1400CHR3206
15,233,218,87,Chiredzi,Chiredzi South,Chiredzi RDC,13,Chilugwi Primary School,1400CHR1301
3,122,119,95,Chiredzi,Chiredzi South,Chiredzi RDC,13,Dhafi Primary School,1400CHR1302
21,225,204,82,Chiredzi,Chiredzi South,Chiredzi RDC,13,Makhanani Primary School,1400CHR1304
19,336,317,89,Chiredzi,Chiredzi South,Chiredzi RDC,14,Bondela Primary School,1400CHR1401
6,98,92,88,Chiredzi,Chiredzi South,Chiredzi RDC,14,Puzani Primary School,1400CHR1405
1,27,26,92,Chiredzi,Chiredzi South,Chiredzi RDC,15,Chilotlela Primary School,1400CHR1502
5,81,76,88,Chiredzi,Chiredzi South,Chiredzi RDC,15,Mugiviza Primary School,1400CHR1507
21,642,621,93,Chiredzi,Chiredzi West,Chiredzi RDC,27,Mutilikwe Secondary School,1400CHR2702
40,589,549,87,Chiredzi,Chiredzi West,Chiredzi RDC,27,Section 64 Pre-School,1400CHR2704
63,722,659,83,Chiredzi,Chiredzi West,Chiredzi RDC,28,C. A. Gibbs Primary School,1400CHR2801
26,250,224,81,Chivi,Chivi Central,Chivi RDC,18,Vuranda Methodist Church,0400BKT2106
43,500,457,84,Chivi,Chivi South,Chivi RDC,26,Dimbiti Primary School,1200CHV2602
29,426,397,87,Chivi,Chivi South,Chivi RDC,29,Dzingirai Primary School,1200CHV2901
32,562,530,89,Chivi,Chivi South,Chivi RDC,29,Simudzirai Primary School,1200CHV2902
11,162,151,87,Gutu,Gutu North,Gutu RDC,3,Maketa Business Centre Tent,2700GTU0302
18,448,430,92,Gutu,Gutu West,Gutu RDC,1,Chikwiza Primary School,2700GTU0101
25,280,255,83,Gutu,Gutu West,Gutu RDC,1,Chipesa Primary School,2700GTU0103
62,681,619,83,Gutu,Gutu West,Gutu RDC,1,Chivake Primary School,2700GTU0105
15,205,190,86,Gutu,Gutu West,Gutu RDC,1,Guzuve Primary School,2700GTU0106
19,304,285,88,Gutu,Gutu West,Gutu RDC,1,Kaguvi Primary School,2700GTU0107
17,333,316,90,Gutu,Gutu West,Gutu RDC,1,Rusununguko Primary School,2700GTU0109
13,382,369,93,Gutu,Gutu West,Gutu RDC,1,Tashinga Primary School,2700GTU0112
53,616,563,84,Gutu,Gutu West,Gutu RDC,7,Mbamba Primary School,2700GTU0701
8,313,305,95,Gutu,Gutu West,Gutu RDC,7,Tariro Primary School,2700GTU0703
16,244,228,87,Gutu,Gutu West,Gutu RDC,7,Zvivingwi Primary School,2700GTU0705
24,291,267,84,Gutu,Gutu West,Gutu RDC,32,Badza Primary School,2700GTU3201
31,318,287,82,Masvingo,Masvingo North,Masvingo RDC,6,Dott Farm Primary School,2200MVO0603
10,347,337,94,Masvingo,Masvingo North,Masvingo RDC,8,Mara Range Farm Shed,2200MVO0803
28,402,374,86,Masvingo,Masvingo North,Masvingo RDC,8,Zvido Primary School,2200MVO0809
20,193,173,81,Masvingo,Masvingo North,Masvingo RDC,32,Beza Primary School,2200MVO3201
9,138,129,87,Masvingo,Masvingo South,Masvingo RDC,29,Zvourongwe Primary School,2200MVO2906
4,296,292,97,Masvingo,Masvingo South,Masvingo RDC,30,Beture Primary School,2200MVO3001
29,307,278,82,Mwenezi,Mwenezi East,Mwenezi RDC,13,Chatagwi Primary School,5400MWE1302
7,206,199,93,Mwenezi,Mwenezi East,Mwenezi RDC,13,Chemhara Primary School Tent,5400MWE1303
5,53,48,82,Mwenezi,Mwenezi East,Mwenezi RDC,13,Chikokoko Primary School,5400MWE1304
13,187,174,87,Mwenezi,Mwenezi East,Mwenezi RDC,13,Chimbi Primary School Tent,5400MWE1305
9,247,238,92,Mwenezi,Mwenezi East,Mwenezi RDC,13,Chiumburu Primary School,5400MWE1307
37,432,395,84,Mwenezi,Mwenezi East,Mwenezi RDC,13,Farai Primary School Tent,5400MWE1308
46,539,493,84,Mwenezi,Mwenezi East,Mwenezi RDC,13,Guramatunhu Primary School,5400MWE1309
10,174,164,89,Mwenezi,Mwenezi East,Mwenezi RDC,13,Humelelo Primary School,5400MWE1310
14,238,224,88,Mwenezi,Mwenezi East,Mwenezi RDC,13,J.B. Primary School Tent,5400MWE1311
3,154,151,96,Mwenezi,Mwenezi East,Mwenezi RDC,13,Machipisa Dip Tank Tent,5400MWE1312
1,68,67,97,Mwenezi,Mwenezi East,Mwenezi RDC,13,Makambi Farm House Tent,5400MWE1313
0,169,169,100,Mwenezi,Mwenezi East,Mwenezi RDC,13,Manyatera Dip Tank Tent,5400MWE1314
21,442,421,90,Mwenezi,Mwenezi East,Mwenezi RDC,13,Marirangwe Primary School,5400MWE1315
33,350,317,82,Mwenezi,Mwenezi East,Mwenezi RDC,13,Masangula Primary School,5400MWE1316
4,398,394,98,Mwenezi,Mwenezi East,Mwenezi RDC,13,Masapwe Primary School,5400MWE1317
48,552,504,84,Mwenezi,Mwenezi East,Mwenezi RDC,13,Masimba Primary School,5400MWE1318
6,264,258,95,Mwenezi,Mwenezi East,Mwenezi RDC,13,Mavambo Primary School Tent,5400MWE1319
23,563,540,92,Mwenezi,Mwenezi East,Mwenezi RDC,13,Mucheni Primary School,5400MWE1320
14,811,797,96,Mwenezi,Mwenezi East,Mwenezi RDC,13,Mukume Primary School,5400MWE1321
4,354,350,97,Mwenezi,Mwenezi East,Mwenezi RDC,13,Mulongwezi (Bjb) Tent,5400MWE1322
10,325,315,94,Mwenezi,Mwenezi East,Mwenezi RDC,13,Munhundishe Primary School,5400MWE1323
17,289,272,88,Mwenezi,Mwenezi East,Mwenezi RDC,13,Muzhanjire Primary School,5400MWE1325
6,292,286,95,Mwenezi,Mwenezi East,Mwenezi RDC,13,Negari Village Tent,5400MWE1326
18,235,217,85,Mwenezi,Mwenezi East,Mwenezi RDC,13,Pelandava Primary School Tent,5400MWE1328
13,234,221,89,Mwenezi,Mwenezi East,Mwenezi RDC,13,Rusaza Primary School,5400MWE1329
13,726,713,96,Mwenezi,Mwenezi East,Mwenezi RDC,13,Sagwari Secondary School,5400MWE1330
28,556,528,90,Mwenezi,Mwenezi East,Mwenezi RDC,13,Tagarika Primary School,5400MWE1331
33,601,568,89,Mwenezi,Mwenezi East,Mwenezi RDC,13,Vilivili Primary School,5400MWE1333
35,679,644,90,Mwenezi,Mwenezi West,Mwenezi RDC,8,Chemvana Primary School,5400MWE0801
4,338,334,97,Mwenezi,Mwenezi West,Mwenezi RDC,8,Hariyoumba Primary School,5400MWE0803
20,653,633,94,Mwenezi,Mwenezi West,Mwenezi RDC,8,Marinda Primary School,5400MWE0804
35,358,323,82,Mwenezi,Mwenezi West,Mwenezi RDC,9,Bangwe Primary School,5400MWE0901
20,467,447,91,Mwenezi,Mwenezi West,Mwenezi RDC,9,Chiwarure Primary School,5400MWE0902
15,261,246,89,Mwenezi,Mwenezi West,Mwenezi RDC,9,Furidzi Primary School,5400MWE0904
7,195,188,93,Mwenezi,Mwenezi West,Mwenezi RDC,9,Manyuchi Primary School,5400MWE0905
20,198,178,81,Mwenezi,Mwenezi West,Mwenezi RDC,10,Chirindi Primary School,5400MWE1001
20,250,230,85,Mwenezi,Mwenezi West,Mwenezi RDC,10,Mazetese Primary School,5400MWE1002
30,308,278,82,Mwenezi,Mwenezi West,Mwenezi RDC,10,Nsimbi Open Space Tent,5400MWE1004
34,361,327,82,Mwenezi,Mwenezi West,Mwenezi RDC,10,Tsungirirai Secondary School,5400MWE1006
20,444,424,91,Mwenezi,Mwenezi West,Mwenezi RDC,11,Chengwe Primary School,5400MWE1101
20,506,486,92,Mwenezi,Mwenezi West,Mwenezi RDC,11,Vongwe Business Centre Tent,5400MWE1103
19,722,703,94,Mwenezi,Mwenezi West,Mwenezi RDC,12,Boterere Primary School,5400MWE1201
27,696,669,92,Mwenezi,Mwenezi West,Mwenezi RDC,12,Shayamavhudzi Primary School,5400MWE1202
48,814,766,88,Mwenezi,Mwenezi West,Mwenezi RDC,14,Chinyu Primary School,5400MWE1401
23,735,712,93,Mwenezi,Mwenezi West,Mwenezi RDC,14,Gwamarara Primary School,5400MWE1403
15,221,206,87,Mwenezi,Mwenezi West,Mwenezi RDC,14,Mangondi Primary School,5400MWE1404
5,496,491,98,Mwenezi,Mwenezi West,Mwenezi RDC,14,Rinette Primary School,5400MWE1405
15,435,420,93,Mwenezi,Mwenezi West,Mwenezi RDC,14,Takura Primary School,5400MWE1406
9,423,414,95,Mwenezi,Mwenezi West,Mwenezi RDC,14,Zvomupungu Primary School,5400MWE1407
6,418,412,97,Mwenezi,Mwenezi West,Mwenezi RDC,15,Chagomoka Primary School,5400MWE1501
6,251,245,95,Mwenezi,Mwenezi West,Mwenezi RDC,15,Chisume Primary School,5400MWE1502
0,113,113,100,Mwenezi,Mwenezi West,Mwenezi RDC,15,Dembe Primary School Tent,5400MWE1503
5,408,403,97,Mwenezi,Mwenezi West,Mwenezi RDC,15,Mateke Primary School Tent,5400MWE1504
5,276,271,96,Mwenezi,Mwenezi West,Mwenezi RDC,15,Matenga Primary School Tent,5400MWE1505
9,382,373,95,Mwenezi,Mwenezi West,Mwenezi RDC,15,Sosonye 2 Tent,5400MWE1508
7,368,361,96,Mwenezi,Mwenezi West,Mwenezi RDC,15,Turf Primary School Tent,5400MWE1509
8,369,361,95,Mwenezi,Mwenezi West,Mwenezi RDC,15,Valley Primary School Tent,5400MWE1510
21,328,307,87,Mwenezi,Mwenezi West,Mwenezi RDC,15,Vezvi Primary School,5400MWE1511
10,587,577,96,Mwenezi,Mwenezi West,Mwenezi RDC,16,Bubi Primary School,5400MWE1601
16,663,647,95,Mwenezi,Mwenezi West,Mwenezi RDC,16,Chipangayi Primary School Tent,5400MWE1602
12,675,663,96,Mwenezi,Mwenezi West,Mwenezi RDC,16,Furumele Primary School,5400MWE1603
25,672,647,92,Mwenezi,Mwenezi West,Mwenezi RDC,16,Mafomoti Primary School,5400MWE1604
44,472,428,82,Mwenezi,Mwenezi West,Mwenezi RDC,16,Munyamani Primary School,5400MWE1605
13,507,494,95,Mwenezi,Mwenezi West,Mwenezi RDC,16,Sandidza Primary School,5400MWE1607
5,525,520,98,Mwenezi,Mwenezi West,Mwenezi RDC,16,Takadevhu Primary School,5400MWE1608
7,380,373,96,Mwenezi,Mwenezi West,Mwenezi RDC,16,Welkom Primary School,5400MWE1609
5,316,311,96,Mwenezi,Mwenezi West,Mwenezi RDC,17,Chamakudo Primary School,5400MWE1701
10,641,631,96,Mwenezi,Mwenezi West,Mwenezi RDC,17,Chavasikana Open Space Tent,5400MWE1702
20,689,669,94,Mwenezi,Mwenezi West,Mwenezi RDC,17,Choverere Primary School,5400MWE1703
12,324,312,92,Mwenezi,Mwenezi West,Mwenezi RDC,17,Dombodema Primary School,5400MWE1704
16,602,586,94,Mwenezi,Mwenezi West,Mwenezi RDC,17,Gadzika Primary School,5400MWE1705
3,555,552,98,Mwenezi,Mwenezi West,Mwenezi RDC,17,Madamwe Primary School,5400MWE1707
3,508,505,98,Mwenezi,Mwenezi West,Mwenezi RDC,17,Makugwe Primary School,5400MWE1708
16,435,419,92,Mwenezi,Mwenezi West,Mwenezi RDC,17,Mayezi Secondary School,5400MWE1709
12,534,522,95,Mwenezi,Mwenezi West,Mwenezi RDC,17,Muraba Primary School Tent,5400MWE1710
13,531,518,95,Mwenezi,Mwenezi West,Mwenezi RDC,17,Mvoko Primary School,5400MWE1711
6,397,391,97,Mwenezi,Mwenezi West,Mwenezi RDC,17,Peregwe Primary School,5400MWE1712
6,475,469,97,Mwenezi,Mwenezi West,Mwenezi RDC,17,Rushangarumwe Primary School,5400MWE1713
11,318,307,93,Mwenezi,Mwenezi West,Mwenezi RDC,17,Taula Primary School Tent,5400MWE1714
9,240,231,92,Zaka,Zaka West,Zaka RDC,29,Shumba Business Centre Tent,8300ZKA2904
34,500,466,87,Chikomba,Chikomba West  ,Chikomba RDC,7,Chigonero Primary School,1800CHIK0702
55,699,644,85,Chikomba,Chikomba West  ,Chikomba RDC,7,Kadungure Primary School,1800CHIK0704
23,311,288,86,Chikomba,Chikomba West  ,Chikomba RDC,7,Manhize Primary School,1800CHIK0706
45,458,413,82,Chikomba,Chikomba West  ,Chikomba RDC,7,Masarirambi Primary School,1800CHIK0707
29,385,356,85,Chikomba,Chikomba West  ,Chikomba RDC,7,Pasichigare Primary School,1800CHIK0708
24,318,294,85,Chikomba,Chikomba West  ,Chikomba RDC,8,Chigara Primary School,1800CHIK0802
16,182,166,83,Goromonzi,Goromonzi North,Goromonzi RDC,9,Saratoga Farm Tent,2500GZI0905
0,47,47,100,Goromonzi,Goromonzi North,Goromonzi RDC,13,Chinyika Farm Shed,2500GZI1302
16,174,158,83,Goromonzi,Goromonzi South ,Goromonzi RDC,17,Eton Farm Tent,2500GZI1702
22,339,317,87,Goromonzi,Goromonzi South ,Goromonzi RDC,17,Rochester Farm Tent,2500GZI1706
18,518,500,93,UMP,Maramba-Pfungwe ,Zvataida RDC,1,Chatseka Primary School,8500ZVA0101
8,229,221,93,UMP,Maramba-Pfungwe ,Zvataida RDC,1,Chatseka Turn Off Tent,8500ZVA0102
6,533,527,97,UMP,Maramba-Pfungwe ,Zvataida RDC,1,Dewe Primary School,8500ZVA0103
13,325,312,92,UMP,Maramba-Pfungwe ,Zvataida RDC,1,Masunzwa Primary School,8500ZVA0104
29,825,796,93,UMP,Maramba-Pfungwe ,Zvataida RDC,1,Nyanzou Primary School,8500ZVA0105
14,542,528,94,UMP,Maramba-Pfungwe ,Zvataida RDC,2,Gowe Business Centre Tent,8500ZVA0201
27,450,423,88,UMP,Maramba-Pfungwe ,Zvataida RDC,2,Kafura Primary School,8500ZVA0202 A
34,415,381,84,UMP,Maramba-Pfungwe ,Zvataida RDC,2,Kafura Primary School,8500ZVA0202 B
9,397,388,95,UMP,Maramba-Pfungwe ,Zvataida RDC,2,Kanzire Primary School,8500ZVA0203
7,406,399,96,UMP,Maramba-Pfungwe ,Zvataida RDC,2,Museka Primary School,8500ZVA0204
2,284,282,98,UMP,Maramba-Pfungwe ,Zvataida RDC,3,Chipawa Primary School,8500ZVA0301
2,191,189,97,UMP,Maramba-Pfungwe ,Zvataida RDC,3,Japachapa Pre-School,8500ZVA0303
18,459,441,92,UMP,Maramba-Pfungwe ,Zvataida RDC,3,Magudu Primary School,8500ZVA0304
8,313,305,95,UMP,Maramba-Pfungwe ,Zvataida RDC,3,Nyakarowa Primary School,8500ZVA0305
11,213,202,90,UMP,Maramba-Pfungwe ,Zvataida RDC,3,Nyakasoro DDF Camp Rest,8500ZVA0306
17,718,701,95,UMP,Maramba-Pfungwe ,Zvataida RDC,3,Patsika Primary School,8500ZVA0307
8,896,888,98,UMP,Maramba-Pfungwe ,Zvataida RDC,4,Chitorangavi Primary School,8500ZVA0401
25,595,570,91,UMP,Maramba-Pfungwe ,Zvataida RDC,4,Chipokoteke Primary School,8500ZVA0402
33,567,534,89,UMP,Maramba-Pfungwe ,Zvataida RDC,4,Chitsungo Primary School,8500ZVA0403
21,642,621,93,UMP,Maramba-Pfungwe ,Zvataida RDC,4,Dindi Secondary School,8500ZVA0404 A
19,636,617,94,UMP,Maramba-Pfungwe ,Zvataida RDC,4,Dindi Secondary School,8500ZVA0404 B
17,858,841,96,UMP,Maramba-Pfungwe ,Zvataida RDC,4,Mungari Primary School,8500ZVA0405
9,667,658,97,UMP,Maramba-Pfungwe ,Zvataida RDC,4,Mupata Business Centre Tent,8500ZVA0406
6,437,431,97,UMP,Maramba-Pfungwe ,Zvataida RDC,5,Kakonde Primary School,8500ZVA0501
17,444,427,92,UMP,Maramba-Pfungwe ,Zvataida RDC,5,Sowa Community Hall,8500ZVA0502 B
13,637,624,96,UMP,Maramba-Pfungwe ,Zvataida RDC,5,Sowa Primary School,8500ZVA0503
52,502,450,81,UMP,Maramba-Pfungwe ,Zvataida RDC,6,Chinhanga Primary School,8500ZVA0601
35,658,623,89,UMP,Maramba-Pfungwe ,Zvataida RDC,6,Saparanyambuya Primary School,8500ZVA0603
6,654,648,98,UMP,Maramba-Pfungwe ,Zvataida RDC,6,Shamba Dip Tank Tent,8500ZVA0604
13,511,498,95,UMP,Maramba-Pfungwe ,Zvataida RDC,7,Barahwe Primary School,8500ZVA0701
0,312,312,100,UMP,Maramba-Pfungwe ,Zvataida RDC,7,Chiwore Primary School,8500ZVA0702
10,360,350,94,UMP,Maramba-Pfungwe ,Zvataida RDC,7,Nyagande Primary School,8500ZVA0703
1,204,203,99,UMP,Maramba-Pfungwe ,Zvataida RDC,7,Nyaguwe Bridge Tent,8500ZVA0704
20,211,191,82,UMP,Maramba-Pfungwe ,Zvataida RDC,7,Shamva Turn Off Tent,8500ZVA0705
35,828,793,91,UMP,Maramba-Pfungwe ,Zvataida RDC,16,Borera Primary School,8500ZVA1601
34,766,732,91,UMP,Maramba-Pfungwe ,Zvataida RDC,16,Guyu Primary School,8500ZVA1602
4,502,498,98,UMP,Maramba-Pfungwe ,Zvataida RDC,16,Halgate Business Centre Tent,8500ZVA1603
1,360,359,99,UMP,Maramba-Pfungwe ,Zvataida RDC,16,Kanjanda Business Centre Tent,8500ZVA1604
12,373,361,93,UMP,Maramba-Pfungwe ,Zvataida RDC,16,Kodogo Business Centre Tent,8500ZVA1605
40,488,448,84,UMP,Maramba-Pfungwe ,Zvataida RDC,17,Bangari Turn Off Tent,8500ZVA1702
0,221,221,100,UMP,Maramba-Pfungwe ,Zvataida RDC,17,Garura Village Pre-School,8500ZVA1703
15,544,529,94,UMP,Maramba-Pfungwe ,Zvataida RDC,17,Kutsokodeka Primary School,8500ZVA1704
6,284,278,95,UMP,Maramba-Pfungwe ,Zvataida RDC,17,Mangere Village Pre-School,8500ZVA1705
2,160,158,97,UMP,Maramba-Pfungwe ,Zvataida RDC,17,Marize Turn Off Tent,8500ZVA1706
8,134,126,88,UMP,Maramba-Pfungwe ,Zvataida RDC,17,Matoranhembe Primary School,8500ZVA1707
10,461,451,95,UMP,Uzumba ,Zvataida RDC,8,Chimhodzi Primary School,8500ZVA0801
44,743,699,88,UMP,Uzumba ,Zvataida RDC,8,Chipfunde Primary School,8500ZVA0802
0,448,448,100,UMP,Uzumba ,Zvataida RDC,8,Gore Village Tent,8500ZVA0804
62,758,696,84,UMP,Uzumba ,Zvataida RDC,8,Marowe Primary School,8500ZVA0805
25,706,681,93,UMP,Uzumba ,Zvataida RDC,8,Simbi Business Centre Tent,8500ZVA0806
67,787,720,84,UMP,Uzumba ,Zvataida RDC,9,Chikuhwa Primary School,8500ZVA0901
43,741,698,89,UMP,Uzumba ,Zvataida RDC,9,Chishayamabvudzi ECD,8500ZVA0902
39,701,662,89,UMP,Uzumba ,Zvataida RDC,9,Nyashonjwa Primary School,8500ZVA0904
38,750,712,90,UMP,Uzumba ,Zvataida RDC,10,Chidodo Primary School,8500ZVA1001
18,646,628,94,UMP,Uzumba ,Zvataida RDC,10,Chidodo Secondary School,8500ZVA1002
27,461,434,88,UMP,Uzumba ,Zvataida RDC,10,Manyika Business Centre Tent,8500ZVA1003
14,330,316,91,UMP,Uzumba ,Zvataida RDC,10,Manyika Dip Tank Tent,8500ZVA1004
25,512,487,90,UMP,Uzumba ,Zvataida RDC,11,Chure Business Centre Tent,8500ZVA1101
17,471,454,93,UMP,Uzumba ,Zvataida RDC,11,Gadaga Primary School,8500ZVA1102
11,213,202,90,UMP,Uzumba ,Zvataida RDC,11,Kachombo Business Centre Tent,8500ZVA1103
3,274,271,97,UMP,Uzumba ,Zvataida RDC,11,Matuku ECD,8500ZVA1104
6,680,674,98,UMP,Uzumba ,Zvataida RDC,11,Nyaruchera Pre-School,8500ZVA1105
35,658,623,89,UMP,Uzumba ,Zvataida RDC,11,Rudawiro Secondary School,8500ZVA1106
12,183,171,87,UMP,Uzumba ,Zvataida RDC,12,Denje Business Centre Tent,8500ZVA1201
35,382,347,83,UMP,Uzumba ,Zvataida RDC,13,Chaitezvi Business Centre Tent,8500ZVA1301
6,185,179,93,UMP,Uzumba ,Zvataida RDC,13,Chimuka Pre-School,8500ZVA1302
52,637,585,84,UMP,Uzumba ,Zvataida RDC,13,Kangara Mapfeka Business Centre Tent,8500ZVA1303
34,326,292,81,UMP,Uzumba ,Zvataida RDC,13,Katsande Business Centre Tent,8500ZVA1304
44,483,439,83,UMP,Uzumba ,Zvataida RDC,13,Matsenga Primary School,8500ZVA1306
22,314,292,86,UMP,Uzumba ,Zvataida RDC,14,Mayema Primary School,8500ZVA1403
11,223,212,90,UMP,Uzumba ,Zvataida RDC,15,Machanzi Business Centre Tent,8500ZVA1504
43,441,398,82,UMP,Uzumba ,Zvataida RDC,15,Mutemaringa Business Centre Tent,8500ZVA1507
13,250,237,90,Marondera,Marondera East  ,Marondera RDC,1,Bothas Rust Farm Tent,4300MAR0102
0,37,37,100,Marondera,Marondera East  ,Marondera RDC,1,Chinwiri Farm Tent,4300MAR0103
16,237,221,87,Marondera,Marondera East  ,Marondera RDC,1,Grandchase Primary School,4300MAR0106
34,364,330,82,Marondera,Marondera East  ,Marondera RDC,2,Essexedale Farm Tent,4300MAR0203
21,249,228,84,Marondera,Marondera East  ,Marondera RDC,3,Mutukwa Secondary School,4300MAR0302
47,593,546,85,Marondera,Marondera East  ,Marondera RDC,3,Dombi Secondary School,4300MAR0303
43,507,464,84,Marondera,Marondera East  ,Marondera RDC,3,Nyamutora Primary School,4300MAR0304
29,323,294,83,Marondera,Marondera East  ,Marondera RDC,3,Suffolk Farm Tent,4300MAR0306
38,426,388,83,Marondera,Marondera East  ,Marondera RDC,6,Tranquility Farm Tent,4300MAR0608
43,569,526,85,Marondera,Marondera East  ,Marondera RDC,7,Chipesa Primary School,4300MAR0701
33,414,381,85,Marondera,Marondera East  ,Marondera RDC,23,Ruwari Ranch Tent,4300MAR2306
29,342,313,84,Mudzi,Mudzi North  ,Mudzi RDC,2,Chori Pre-School,4900MDZ0202
33,418,385,85,Mudzi,Mudzi North  ,Mudzi RDC,2,Vhombozi Primary School,4900MDZ0208
23,235,212,82,Mudzi,Mudzi North  ,Mudzi RDC,2,Vhombozi Turn Off Tent,4900MDZ0209
23,421,398,89,Mudzi,Mudzi North  ,Mudzi RDC,3,Chimukoko Business Centre Chief's Hall,4900MDZ0301
40,646,606,88,Mudzi,Mudzi North  ,Mudzi RDC,3,Chimukoko Primary School,4900MDZ0302
26,343,317,85,Mudzi,Mudzi North  ,Mudzi RDC,3,Jumbe Primary School,4900MDZ0303
23,450,427,90,Mudzi,Mudzi North  ,Mudzi RDC,3,Kudzwe Primary School,4900MDZ0304
47,739,692,88,Mudzi,Mudzi North  ,Mudzi RDC,3,Nyamanyora Primary School,4900MDZ0305
31,393,362,85,Mudzi,Mudzi North  ,Mudzi RDC,3,Rukonde Primary School,4900MDZ0306
10,182,172,89,Mudzi,Mudzi North  ,Mudzi RDC,9,Kondo Turn Off Tent,4900MDZ0902
34,512,478,87,Mudzi,Mudzi North  ,Mudzi RDC,9,Nyamhondoro Primary School,4900MDZ0904 A
43,510,467,84,Mudzi,Mudzi North  ,Mudzi RDC,9,Nyamhondoro Primary School,4900MDZ0904 B
19,396,377,90,Mudzi,Mudzi North  ,Mudzi RDC,17,Nyahuku Tuckshop Tent,4900MDZ1703
16,344,328,91,Mudzi,Mudzi North  ,Mudzi RDC,17,St Pius Primary School,4900MDZ1705
27,275,248,82,Mudzi,Mudzi South  ,Mudzi RDC,13,Makosa Pre-School,4900MDZ1304
14,546,532,95,Mudzi,Mudzi South  ,Mudzi RDC,14,Banze Primary School,4900MDZ1401
35,417,382,84,Mudzi,Mudzi South  ,Mudzi RDC,14,Mutondo Business Centre Tent,4900MDZ1403 A
17,396,379,91,Mudzi,Mudzi South  ,Mudzi RDC,14,Nyasanhi Pre-School,4900MDZ1404
16,522,506,94,Mudzi,Mudzi South  ,Mudzi RDC,14,Nyarutepo Primary School,4900MDZ1405 A
14,532,518,94,Mudzi,Mudzi South  ,Mudzi RDC,14,Nyarutepo Primary School,4900MDZ1405 B
25,641,616,92,Mudzi,Mudzi South  ,Mudzi RDC,14,Rwamba Primary School,4900MDZ1406 A
32,608,576,90,Mudzi,Mudzi South  ,Mudzi RDC,14,Rwamba Primary School,4900MDZ1406 B
48,515,467,82,Mudzi,Mudzi South  ,Mudzi RDC,15,Chikwizo Primary School,4900MDZ1501 A
45,529,484,84,Mudzi,Mudzi South  ,Mudzi RDC,15,Chikwizo Primary School,4900MDZ1501 B
64,636,572,81,Mudzi,Mudzi South  ,Mudzi RDC,15,Mupfuti Business Centre Tent,4900MDZ1503
4,41,37,82,Mudzi,Mudzi South  ,Mudzi RDC,15,Nyakatewetewe Tent,4900MDZ1504
60,637,577,82,Mudzi,Mudzi South  ,Mudzi RDC,15,Nyamande Primary School,4900MDZ1505 A
58,651,593,83,Mudzi,Mudzi South  ,Mudzi RDC,15,Nyamande Primary School,4900MDZ1505 B
33,717,684,91,Mudzi,Mudzi South  ,Mudzi RDC,16,Chitungwira Pre-School,4900MDZ1601
25,437,412,89,Mudzi,Mudzi South  ,Mudzi RDC,16,Gozi Primary School,4900MDZ1602 A
28,425,397,87,Mudzi,Mudzi South  ,Mudzi RDC,16,Gozi Primary School,4900MDZ1602 B
9,126,117,86,Mudzi,Mudzi South  ,Mudzi RDC,16,Nyamusanzara Business Centre Tent,4900MDZ1605
19,229,210,84,Mudzi,Mudzi South  ,Mudzi RDC,16,Nyamhasa Grinding Mill Tent,4900MDZ1606
47,465,418,81,Mudzi,Mudzi South  ,Mudzi RDC,18,Mavhurazi Primary School,4900MDZ1802
37,441,404,84,Mudzi,Mudzi South  ,Mudzi RDC,18,Mavhurazi Nyamatawa Turn Off Tent,4900MDZ1803
25,279,254,83,Mudzi,Mudzi South  ,Mudzi RDC,18,Nhunzvi Borehole Tent,4900MDZ1804
31,558,527,89,Mudzi,Mudzi West  ,Mudzi RDC,4,Chimango Primary School,4900MDZ0401 A
34,577,543,88,Mudzi,Mudzi West  ,Mudzi RDC,4,Chimango Primary School,4900MDZ0401 B
18,521,503,93,Mudzi,Mudzi West  ,Mudzi RDC,4,Chisvo Primary School,4900MDZ0402
11,463,452,95,Mudzi,Mudzi West  ,Mudzi RDC,4,DDF Rest Camp,4900MDZ0403
9,314,305,94,Mudzi,Mudzi West  ,Mudzi RDC,4,Kasiyo Primary School,4900MDZ0404
21,384,363,89,Mudzi,Mudzi West  ,Mudzi RDC,4,Shinga Primary School,4900MDZ0405
25,767,742,93,Mudzi,Mudzi West  ,Mudzi RDC,4,Tsakare Primary School,4900MDZ0406
5,244,239,95,Mudzi,Mudzi West  ,Mudzi RDC,5,Benson Mine Business Centre Tent,4900MDZ0501
9,266,257,93,Mudzi,Mudzi West  ,Mudzi RDC,5,Chindoko Primary School,4900MDZ0502
23,431,408,89,Mudzi,Mudzi West  ,Mudzi RDC,5,Chipfuti Primary School,4900MDZ0503
41,464,423,83,Mudzi,Mudzi West  ,Mudzi RDC,5,Chiunye Primary School,4900MDZ0504
34,494,460,87,Mudzi,Mudzi West  ,Mudzi RDC,5,Kamusori Primary School,4900MDZ0505
6,306,300,96,Mudzi,Mudzi West  ,Mudzi RDC,5,Nyadire Bridge Tent,4900MDZ0506
10,229,219,91,Mudzi,Mudzi West  ,Mudzi RDC,5,Nyapfunde Primary School,4900MDZ0507
20,431,411,91,Mudzi,Mudzi West  ,Mudzi RDC,6,Chingururu Business Centre Tent,4900MDZ0601
47,786,739,88,Mudzi,Mudzi West  ,Mudzi RDC,6,Masenda Primary School,4900MDZ0602
11,475,464,95,Mudzi,Mudzi West  ,Mudzi RDC,6,Mutohwe Orphanage Centre,4900MDZ0603
57,572,515,81,Mudzi,Mudzi West  ,Mudzi RDC,6,Nyamukoho Primary School,4900MDZ0604
27,564,537,90,Mudzi,Mudzi West  ,Mudzi RDC,7,Chitambazi Primary School,4900MDZ0702
23,515,492,91,Mudzi,Mudzi West  ,Mudzi RDC,7,Majapani Business Centre Tent,4900MDZ0705
50,533,483,82,Murewa,Murewa North,Murewa RDC,1,Guzha Primary School,4700MRE0101
42,513,471,84,Murewa,Murewa North,Murewa RDC,2,Matenha Pre-School,4700MRE0203
61,757,696,85,Murewa,Murewa South,Murewa RDC,22,Barrymore Primary School,4700MRE2201
36,551,515,87,Murewa,Murewa South,Murewa RDC,22,Chilinda Primary School,4700MRE2202
42,792,750,89,Murewa,Murewa South,Murewa RDC,22,Dzete Secondary School,4700MRE2204
7,292,285,95,Murewa,Murewa South,Murewa RDC,22,Highover Farm Tent,4700MRE2205
26,849,823,94,Murewa,Murewa South,Murewa RDC,22,Nyagadzi Primary School,4700MRE2206
25,351,326,86,Murewa,Murewa South,Murewa RDC,22,River Valley Primary School,4700MRE2207
35,421,386,84,Murewa,Murewa South,Murewa RDC,22,Salama Sheds,4700MRE2209
17,485,468,93,Murewa,Murewa South,Murewa RDC,22,Vanguard Farmhouse Tent,4700MRE2210
26,394,368,87,Murewa,Murewa South,Murewa RDC,23,Howgate Farmhouse Tent,4700MRE2303
27,303,276,83,Murewa,Murewa South,Murewa RDC,23,Takunda Primary School,4700MRE2304
39,387,348,81,Murewa,Murewa South,Murewa RDC,23,Welcome Home Clinic,4700MRE2307
37,437,400,84,Murewa,Murewa South,Murewa RDC,24,Craiglea Primary School,4700MRE2401 A
25,252,227,81,Murewa,Murewa South,Murewa RDC,24,Mushawatu Primary School,4700MRE2404
41,505,464,84,Murewa,Murewa South,Murewa RDC,24,Nyamita Primary School,4700MRE2405 A
34,497,463,87,Murewa,Murewa South,Murewa RDC,24,Nyamita Primary School,4700MRE2405 B
36,418,382,84,Murewa,Murewa South,Murewa RDC,24,St Columbus Primary School,4700MRE2406 A
10,129,119,85,Murewa,Murewa West,Murewa RDC,15,Kazviyo Business Centre Tent,4700MRE1503
25,422,397,88,Mutoko,Mutoko East,Mutoko RDC,9,Mbudzi Business Centre Tent,4800MTK0902
24,283,259,84,Mutoko,Mutoko East,Mutoko RDC,14,DDF camp Rest,4800MTK1402
24,368,344,87,Mutoko,Mutoko East,Mutoko RDC,14,Dombo Business Centre Tent,4800MTK1403
15,326,311,91,Mutoko,Mutoko East,Mutoko RDC,15,Chapanduka Business Centre Tent,4800MTK1501
42,576,534,86,Mutoko,Mutoko East,Mutoko RDC,15,Chikukwa Primary School,4800MTK1502
28,623,595,91,Mutoko,Mutoko East,Mutoko RDC,18,Chisambiro Primary School,4800MTK1803
6,218,212,94,Mutoko,Mutoko East,Mutoko RDC,18,Kangoza Business Centre Tent,4800MTK1805
40,531,491,85,Mutoko,Mutoko East,Mutoko RDC,18,Mapona Business Centre Tent,4800MTK1806
7,267,260,94,Mutoko,Mutoko East,Mutoko RDC,18,Mutunhike Village Tent,4800MTK1807
29,413,384,86,Mutoko,Mutoko East,Mutoko RDC,19,Chibeta Primary School,4800MTK1901
33,515,482,87,Mutoko,Mutoko East,Mutoko RDC,19,Domborinenhiwi Primary School,4800MTK1903
3,383,380,98,Mutoko,Mutoko East,Mutoko RDC,19,Hudya Primary School,4800MTK1904
43,554,511,85,Mutoko,Mutoko East,Mutoko RDC,19,Makora Primary School,4800MTK1905
5,111,106,91,Mutoko,Mutoko East,Mutoko RDC,19,Muhomba Village Tent,4800MTK1906
5,183,178,94,Mutoko,Mutoko East,Mutoko RDC,19,Musapawenyanza Tent,4800MTK1907
4,334,330,97,Mutoko,Mutoko North,Mutoko RDC,1,Chireka Pre-School,4800MTK0101
6,244,238,95,Mutoko,Mutoko North,Mutoko RDC,1,Mabiko Pre-School,4800MTK0104
15,190,175,85,Mutoko,Mutoko North,Mutoko RDC,1,Rukwenjere Business Centre Tent,4800MTK0106
50,624,574,85,Mutoko,Mutoko North,Mutoko RDC,2,Chindenga Primary School,4800MTK0201
31,371,340,84,Mutoko,Mutoko North,Mutoko RDC,2,Chinogurei Business Centre Tent,4800MTK0202
8,292,284,94,Mutoko,Mutoko North,Mutoko RDC,2,Chirindi Primary School,4800MTK0203
23,522,499,91,Mutoko,Mutoko North,Mutoko RDC,2,Gwariwa Primary School,4800MTK0204
41,666,625,88,Mutoko,Mutoko North,Mutoko RDC,2,Makokoro Business Centre Tent,4800MTK0205
21,238,217,83,Mutoko,Mutoko North,Mutoko RDC,3,Mungongoma Business Centre Tent,4800MTK0303
25,260,235,82,Mutoko,Mutoko North,Mutoko RDC,4,Kuwirirana Pre-School,4800MTK0403
13,193,180,87,Mutoko,Mutoko North,Mutoko RDC,4,Madimutsa Secondary School,4800MTK0405
7,78,71,83,Mutoko,Mutoko North,Mutoko RDC,5,Mvundura Business Centre Tent,4800MTK0504
2,70,68,94,Mutoko,Mutoko South,Mutoko RDC,23,Katehwe Village Tent,4800MTK2303
7,80,73,83,Mutoko,Mutoko South,Mutoko RDC,24,Dhuku Dam Primary School,4800MTK2401
12,116,104,81,Mutoko,Mutoko South,Mutoko RDC,25,Charumbira village Tent,4800MTK2501
33,420,387,85,Mutoko,Mutoko South,Mutoko RDC,25,Chimurenga Primary School,4800MTK2502 A
27,425,398,88,Mutoko,Mutoko South,Mutoko RDC,25,Chimurenga Primary School,4800MTK2502 B
30,707,677,91,Mutoko,Mutoko South,Mutoko RDC,25,Ganyambadze Primary School,4800MTK2503
38,504,466,85,Mutoko,Mutoko South,Mutoko RDC,25,Nyahurunguhwe Primary School,4800MTK2505
29,831,802,93,Mutoko,Mutoko South,Mutoko RDC,25,Zvidozvevanhu Primary School,4800MTK2508
13,248,235,90,Mutoko,Mutoko South,Mutoko RDC,26,Ronchester Tent,4800MTK2606
18,253,235,86,Mutoko,Mutoko South,Mutoko RDC,27,Chidowe Primary School,4800MTK2702
14,277,263,90,Mutoko,Mutoko South,Mutoko RDC,27,Hari Business Centre Tent,4800MTK2703
29,284,255,81,Mutoko,Mutoko South,Mutoko RDC,27,Mazarura Farm Tent,4800MTK2704
16,525,509,94,Mutoko,Mutoko South,Mutoko RDC,27,Nyagore Primary School,4800MTK2706
30,506,476,88,Mutoko,Mutoko South,Mutoko RDC,27,Nyamakosi Farm Tent,4800MTK2707
38,500,462,85,Mutoko,Mutoko South,Mutoko RDC,27,Parirenyatwa Primary School,4800MTK2708
38,602,564,88,Mutoko,Mutoko South,Mutoko RDC,28,Chikara Primary School,4800MTK2801
32,556,524,89,Mutoko,Mutoko South,Mutoko RDC,28,Chinyika Primary School,4800MTK2802
31,401,370,85,Mutoko,Mutoko South,Mutoko RDC,28,Nyadzonya Primary School,4800MTK2803
34,375,341,83,Mutoko,Mutoko South,Mutoko RDC,29,Dombodzvipa Primary School,4800MTK2901
23,286,263,85,Mutoko,Mutoko South,Mutoko RDC,29,Hurumutumbu Primary School,4800MTK2902
17,293,276,89,Mutoko,Mutoko South,Mutoko RDC,29,Kwaedza Primary School,4800MTK2903
20,312,292,87,Mutoko,Mutoko South,Mutoko RDC,29,Lucky Dip Business Centre Tent,4800MTK2904
44,455,411,82,Mutoko,Mutoko South,Mutoko RDC,29,Nyarushipe Primary School,4800MTK2906
26,325,299,85,Mutoko,Mutoko South,Mutoko RDC,29,Ruvimbo Primary School,4800MTK2908
12,229,217,90,Mutoko,Mutoko South,Mutoko RDC,29,Tongogara Primary School,4800MTK2909
8,395,387,96,Mutoko,Mutoko South,Mutoko RDC,29,Village 90 Tent,4800MTK2911
13,189,176,87,Wedza,Wedza North  ,Marondera RDC,5,Dourne Estate Tent,4300MAR0501
20,268,248,86,Wedza,Wedza North  ,Marondera RDC,8,Chop Chop Business Centre Tent,4300MAR0803
12,186,174,87,Wedza,Wedza North  ,Marondera RDC,8,Mt Authur Primary School,4300MAR0805
15,152,137,82,Wedza,Wedza North  ,Marondera RDC,8,Rujeko Primary School,4300MAR0806
18,200,182,83,Wedza,Wedza North  ,Wedza RDC,1,Cloutsham Primary School,8000WED0103
47,487,440,82,Wedza,Wedza North  ,Wedza RDC,2,Fels Primary School,8000WED0204
34,445,411,85,Wedza,Wedza North  ,Wedza RDC,2,Nelson Primary School,8000WED0205
19,279,260,87,Wedza,Wedza North  ,Wedza RDC,2,Scorror Tent,8000WED0207
30,388,358,85,Wedza,Wedza North  ,Wedza RDC,3,Dendende Farm House Tent,8000WED0301
10,348,338,94,Wedza,Wedza North  ,Wedza RDC,4,Bita Primary School,8000WED0401
13,162,149,85,Chimanimani,Chimanimani East,Chimanimani RDC,1,Nyambeya 2 Primary School,4400CHM0103
20,230,210,84,Chimanimani,Chimanimani East,Chimanimani RDC,1,Nyembeya Estate Tent,4400CHM0104
3,110,107,94,Chimanimani,Chimanimani East,Chimanimani RDC,1,Ruwedza Primary School,4400CHM0105
1,54,53,96,Chimanimani,Chimanimani East,Chimanimani RDC,1,Tandai Estate Tent,4400CHM0107
44,422,378,81,Chimanimani,Chimanimani East,Chimanimani RDC,1,Thabanchu Primary School,4400CHM0108
28,366,338,85,Chimanimani,Chimanimani East,Chimanimani RDC,7,Quaggas Farm House,4400CHM0706
6,141,135,91,Chimanimani,Chimanimani East,Chimanimani RDC,11,Hangani Primary School,4400CHM1102
3,182,179,96,Chimanimani,Chimanimani East,Chimanimani RDC,11,Jantia Farm House Tent,4400CHM1104
50,536,486,82,Chimanimani,Chimanimani East,Chimanimani RDC,12,Charleswood Primary School,4400CHM1201
12,132,120,83,Chimanimani,Chimanimani East,Chimanimani RDC,12,Broki Tent,4400CHM1206
10,337,327,94,Chimanimani,Chimanimani East,Chimanimani RDC,14,Thornton Primary School,4400CHM1403
36,402,366,83,Chipinge,Chipinge Central,Chipinge RDC,7,Wedgehill Farm Shed,1300CPG0703
24,414,390,89,Chipinge,Chipinge Central,Chipinge RDC,8,Mugiyo (Vermont A & B) Primary School,1300CPG0802
21,243,222,84,Chipinge,Chipinge Central,Chipinge RDC,10,DinglyDell Creche Tent,1300CPG1003
23,534,511,91,Makoni,Makoni South,Makoni RDC,31,Village 13 Tent,4200MKI3104
11,116,105,82,Mutasa,Mutasa North,Mutasa RDC,2,Chipote Resettlement Tent,5000MTS0202
54,549,495,82,Mutare,Mutare West,Mutare RDC,16,St Noah Primary School A,7500MTR1606 A
47,579,532,84,Mutare,Mutare West,Mutare RDC,16,St Noah Primary School B,7500MTR1606 B
35,2,-33,-89,Harare,Budiriro,Harare Municipality,43,Open Space Lake Chivero Tent,6301HRE4311
28,314,286,83,Chegutu,Chegutu East,Chegutu RDC,12,Homedale Clinic Tent,3200CHE1202
42,491,449,84,Chegutu,Chegutu East,Chegutu RDC,12,Lothian Farm House,3200CHE1204
13,209,196,88,Chegutu,Chegutu East,Chegutu RDC,12,Masden Farm House,3200CHE1205
32,410,378,85,Chegutu,Chegutu East,Chegutu RDC,22,Danangwe Primary School,3200CHE2203
14,210,196,87,Chegutu,Chegutu East,Chegutu RDC,22,Garamwe Primary School,3200CHE2205
26,349,323,86,Chegutu,Chegutu East,Chegutu RDC,22,Ijapo Primary School,3200CHE2206
152,0,-152,-100,Chegutu,Chegutu West,Chegutu Municipality,12,Proposed Primary school Site (Stand 29326 Tent,3201CHM1205
31,378,347,84,Hurungwe,Hurungwe Central,Hurungwe RDC,1,Helywn Primary School,3800HUR0101
21,311,290,87,Hurungwe,Hurungwe Central,Hurungwe RDC,1,Mahuti Farm House,3800HUR0103
47,491,444,82,Hurungwe,Hurungwe Central,Hurungwe RDC,1,Songalalo Primary School,3800HUR0110
17,172,155,82,Hurungwe,Hurungwe Central,Hurungwe RDC,5,Iddlewood Farm House,3800HUR0503
10,157,147,88,Hurungwe,Hurungwe Central,Hurungwe RDC,5,Maunga Farm House,3800HUR0505
37,580,543,88,Hurungwe,Hurungwe Central,Hurungwe RDC,5,Rufaro Farm Tent,3800HUR0507
35,731,696,90,Hurungwe,Hurungwe Central,Hurungwe RDC,18,Dixie Primary School,3800HUR1802
19,312,293,88,Hurungwe,Hurungwe Central,Hurungwe RDC,18,Lanlory Primary School,3800HUR1805
10,208,198,90,Hurungwe,Hurungwe Central,Hurungwe RDC,18,Laughing Hills Farm House,3800HUR1806
36,429,393,84,Hurungwe,Hurungwe Central,Hurungwe RDC,18,Mukuyu Primary School,3800HUR1807
31,419,388,86,Hurungwe,Hurungwe Central,Hurungwe RDC,18,Tavoy Primary School,3800HUR1808
11,328,317,93,Hurungwe,Hurungwe Central,Hurungwe RDC,18,Trokiadza Farm House,3800HUR1809
4,342,338,97,Hurungwe,Hurungwe Central,Hurungwe RDC,18,Yawanda Farm House,3800HUR1810
13,174,161,86,Hurungwe,Hurungwe East,Hurungwe RDC,2,Dentaow Farm House,3800HUR0202
22,483,461,91,Hurungwe,Hurungwe East,Hurungwe RDC,2,Ian Penny/Kemasimbi Settlement Farm,3800HUR0203
59,595,536,81,Hurungwe,Hurungwe East,Hurungwe RDC,2,Masikati Primary School,3800HUR0204
24,295,271,84,Hurungwe,Hurungwe East,Hurungwe RDC,2,Pollux Estate Farm House,3800HUR0207
19,265,246,86,Hurungwe,Hurungwe East,Hurungwe RDC,2,Rhodes Farm House,3800HUR0208
18,508,490,93,Hurungwe,Hurungwe East,Hurungwe RDC,3,Garahanga Farm House,3800HUR0302
38,517,479,86,Hurungwe,Hurungwe East,Hurungwe RDC,3,Mauya Secondary School,3800HUR0304
44,426,382,81,Hurungwe,Hurungwe East,Hurungwe RDC,3,Zebra Downs Primary School,3800HUR0307 A
32,319,287,81,Hurungwe,Hurungwe East,Hurungwe RDC,6,Dambanzara Primary School,3800HUR0602
12,169,157,86,Hurungwe,Hurungwe East,Hurungwe RDC,14,Kangurunguru Primary School,3800HUR1408
64,643,579,81,Hurungwe,Hurungwe East,Hurungwe RDC,19,Madzimoyo Primary School,3800HUR1903
20,234,214,84,Hurungwe,Hurungwe East,Hurungwe RDC,19,Nevern Plaice Primary School,3800HUR1904
10,119,109,84,Hurungwe,Hurungwe East,Hurungwe RDC,20,Inverness Farm house,3800HUR2004
49,587,538,84,Hurungwe,Hurungwe East,Hurungwe RDC,20,Lazy Five Primary School,3800HUR2005
53,785,732,87,Hurungwe,Hurungwe East,Hurungwe RDC,21,Hesketh Park Primary School,3800HUR2102
10,134,124,86,Hurungwe,Hurungwe North,Hurungwe RDC,9,Mpuse Primary School,3800HUR0911
1,24,23,92,Kariba,Kariba,Nyaminyami RDC,2,Gatshe Gatshe Irrigation Tent,3700NYA0201
413,33,-380,-85,Kariba,Kariba,Nyaminyami RDC,3,Dhove Pre-School Tent,3700NYA0302
40,4,-36,-81,Kariba,Kariba,Nyaminyami RDC,4,Sibilobilo Fishing Camp Tent,3700NYA0407
2,47,45,91,Kariba,Kariba,Nyaminyami RDC,7,Chipfidze Pre-School Tent,3700NYA0702
22,316,294,86,Kariba,Kariba,Nyaminyami RDC,10,Gunguhwe Primary School,3700NYA1001
6,129,123,91,Kariba,Kariba,Nyaminyami RDC,11,Hurenje Pre-School Tent,3700NYA1101
15,310,295,90,Makonde,Makonde,Makonde RDC,8,Chipo Primary School,7000MAK0802
30,606,576,90,Makonde,Makonde,Makonde RDC,8,Fiona Primary School,7000MAK0803
49,544,495,83,Makonde,Makonde,Makonde RDC,8,Kemukaka Primary School,7000MAK0806
35,640,605,89,Makonde,Makonde,Makonde RDC,8,Maysma Primary School,7000MAK0807
17,303,286,89,Makonde,Makonde,Makonde RDC,8,Musoromuchena Primary School,7000MAK0808
28,616,588,91,Makonde,Makonde,Makonde RDC,8,Nyamatanda Primary School,7000MAK0809
34,378,344,83,Makonde,Makonde,Makonde RDC,8,Nyamatsitu Farm Settlement Tent,7000MAK0810
34,423,389,85,Makonde,Makonde,Makonde RDC,8,Poker Ranch (Chitena) Tent,7000MAK0812
42,676,634,88,Makonde,Makonde,Makonde RDC,8,West Ranch Primary School,7000MAK0814
21,327,306,87,Makonde,Makonde,Makonde RDC,9,Magogi Secondary School,7000MAK0903
38,507,469,86,Makonde,Makonde,Makonde RDC,9,Manyamba Primary School,7000MAK0904
36,364,328,82,Makonde,Makonde,Makonde RDC,19,Listonshields Primary School,7000MAK1905
26,448,422,89,Makonde,Mhangura,Makonde RDC,1,Binge Primary School,7000MAK0101 A
21,454,433,91,Makonde,Mhangura,Makonde RDC,1,Binge Primary School,7000MAK0101 B
18,340,322,89,Makonde,Mhangura,Makonde RDC,1,Chipiri/Chitatu Primary School,7000MAK0102
12,410,398,94,Makonde,Mhangura,Makonde RDC,1,Doma Safari Primary School,7000MAK0103
22,407,385,89,Makonde,Mhangura,Makonde RDC,1,Jechenene Primary School,7000MAK0104
25,574,549,91,Makonde,Mhangura,Makonde RDC,1,Kosana Primary School,7000MAK0105
16,714,698,95,Makonde,Mhangura,Makonde RDC,1,Vrede Primary School,7000MAK0106
15,328,313,91,Makonde,Mhangura,Makonde RDC,2,Chimanimani Secondary School,7000MAK0201
11,145,134,85,Makonde,Mhangura,Makonde RDC,2,Mukuyu Primary School,7000MAK0202
16,382,366,91,Makonde,Mhangura,Makonde RDC,2,Gravelotte Primary School,7000MAK0205
14,407,393,93,Makonde,Mhangura,Makonde RDC,2,Ozana Primary School,7000MAK0206
49,642,593,85,Makonde,Mhangura,Makonde RDC,2,Mukamba Secondary School,7000MAK0208
13,333,320,92,Makonde,Mhangura,Makonde RDC,2,Northend Primary School,7000MAK0209
15,463,448,93,Makonde,Mhangura,Makonde RDC,3,Two Tree Dam Primary School,7000MAK0304
21,355,334,88,Makonde,Mhangura,Makonde RDC,4,Devonia Primary School,7000MAK0403
26,331,305,85,Makonde,Mhangura,Makonde RDC,4,Gombera Primary School,7000MAK0405
26,315,289,84,Makonde,Mhangura,Makonde RDC,4,Urume Secondary School,7000MAK0408
33,315,282,81,Makonde,Mhangura,Makonde RDC,4,Silverhills Primary School,7000MAK0411
25,436,411,89,Makonde,Mhangura,Makonde RDC,5,Fynnland Primary School,7000MAK0502 A
18,440,422,92,Makonde,Mhangura,Makonde RDC,5,Fynnland Primary School,7000MAK0502 B
20,308,288,87,Makonde,Mhangura,Makonde RDC,5,Tendera Primary School,7000MAK0505
25,560,535,91,Makonde,Mhangura,Makonde RDC,6,East Range Primary School,7000MAK0602
35,550,515,88,Makonde,Mhangura,Makonde RDC,6,Glynammel Primary School,7000MAK0603
12,234,222,90,Makonde,Mhangura,Makonde RDC,6,Nyamugomba Clinic,7000MAK0605
15,339,324,91,Makonde,Mhangura,Makonde RDC,11,Onapatari Primary School,7000MAK1106
27,400,373,87,Makonde,Mhangura,Makonde RDC,11,Ponderosa Primary School,7000MAK1107 A
29,397,368,86,Makonde,Mhangura,Makonde RDC,11,Ponderosa Primary School,7000MAK1107 B
20,464,444,91,Makonde,Mhangura,Makonde RDC,11,Wildene Primary School,7000MAK1109
16,175,159,83,Makonde,Mhangura,Makonde RDC,13,Arcadia Farm Settlement,7000MAK1301
29,314,285,83,Makonde,Mhangura,Makonde RDC,13,Chisaki Farm Settlement,7000MAK1302
7,137,130,90,Makonde,Mhangura,Makonde RDC,13,Highlands Farm Settlement,7000MAK1304
19,198,179,82,Makonde,Mhangura,Makonde RDC,13,Muni Primary School,7000MAK1306
23,350,327,87,Makonde,Mhangura,Makonde RDC,13,Pfupi Primary School,7000MAK1307
21,214,193,82,Mhondoro-Ngezi,Mhondoro-Ngezi,Mhondoro-Ngezi RDC,10,Paraiwa Tent,1000MNG1004
58,711,653,84,Mhondoro-Ngezi,Muzvezve,Mhondoro-Ngezi RDC,12,Muzvezve Block 8 Primary School,1000MNG1203
23,396,373,89,Mhondoro-Ngezi,Muzvezve,Mhondoro-Ngezi RDC,12,Sable Ranch Primary School,1000MNG1205
58,616,558,82,Sanyati,Chakari,Sanyati RDC,1,Blue Grass Primary School,2400SAN0101
22,242,220,83,Sanyati,Chakari,Sanyati RDC,1,Findon Farm Tent,2400SAN0105
7,390,383,96,Sanyati,Chakari,Sanyati RDC,1,Rooney Estate Tent,2400SAN0113
11,238,227,91,Sanyati,Chakari,Sanyati RDC,2,Barclay Chase Farm Tent,2400SAN0202
30,473,443,88,Sanyati,Chakari,Sanyati RDC,2,Barclay Chase Primary,2400SAN0203
11,259,248,91,Sanyati,Chakari,Sanyati RDC,2,East Medina Farm Shed,2400SAN0204
11,235,224,91,Sanyati,Chakari,Sanyati RDC,2,Massachusets Farm ECD Building,2400SAN0207
22,355,333,88,Sanyati,Chakari,Sanyati RDC,2,Milanwood Farm Secondary School,2400SAN0209
23,440,417,90,Sanyati,Chakari,Sanyati RDC,2,Milverton Primary School,2400SAN0210
44,758,714,89,Sanyati,Chakari,Sanyati RDC,2,Rondor Primary School,2400SAN0213
38,368,330,81,Sanyati,Chakari,Sanyati RDC,2,Sunnybank Primary School,2400SAN0214 A
26,382,356,87,Sanyati,Chakari,Sanyati RDC,2,Sunnybank Primary School,2400SAN0214 B
34,533,499,88,Sanyati,Chakari,Sanyati RDC,3,Blackmorevale Primary School,2400SAN0301 A
25,547,522,91,Sanyati,Chakari,Sanyati RDC,3,Blackmorevale Primary School,2400SAN0301 B
13,191,178,87,Sanyati,Chakari,Sanyati RDC,3,Chadchunt Farm Tent,2400SAN0302
17,391,374,91,Sanyati,Chakari,Sanyati RDC,3,Mopani (Chavey Chase) Tent,2400SAN0303
7,299,292,95,Sanyati,Chakari,Sanyati RDC,3,Deweras Farm Shed,2400SAN0306
24,521,497,91,Sanyati,Chakari,Sanyati RDC,3,Esterlea Primary School,2400SAN0307 A
39,494,455,85,Sanyati,Chakari,Sanyati RDC,3,Esterlea Primary School,2400SAN0307 B
39,518,479,85,Sanyati,Chakari,Sanyati RDC,3,Kabanga (Rhod Plant Plantation) Tent,2400SAN0309
32,468,436,87,Sanyati,Chakari,Sanyati RDC,4,Gambiza Shopping Centre Tent,2400SAN0403
37,466,429,85,Sanyati,Chakari,Sanyati RDC,4,Mamvuramachena Primary School,2400SAN0406
36,701,665,90,Sanyati,Chakari,Sanyati RDC,5,Batanai (Vere) Secondary School,2400SAN0501
45,522,477,84,Sanyati,Chakari,Sanyati RDC,5,Boterekwa Primary School,2400SAN0502
35,635,600,89,Sanyati,Chakari,Sanyati RDC,5,Jarahwa Primary School,2400SAN0503
11,231,220,90,Sanyati,Chakari,Sanyati RDC,5,Marimari Primary School,2400SAN0504
4,83,79,90,Sanyati,Chakari,Sanyati RDC,5,Marimari South Tent,2400SAN0505
24,364,340,87,Sanyati,Chakari,Sanyati RDC,5,Musambanyama Primary School,2400SAN0506
71,688,617,81,Sanyati,Chakari,Sanyati RDC,5,Nyoka Business Centre Tent,2400SAN0508
27,641,614,91,Sanyati,Chakari,Sanyati RDC,5,Platinum Primary School,2400SAN0509
40,383,343,81,Sanyati,Chakari,Sanyati RDC,7,Nharire Primary School,2400SAN0703
3,88,85,93,Sanyati,Chakari,Sanyati RDC,7,Village 8 Tent,2400SAN0704
37,499,462,86,Sanyati,Sanyati,Sanyati RDC,16,Madzivaenzou Primary School,2400SAN1604
14,321,307,91,Sanyati,Sanyati,Sanyati RDC,16,Sarukweza Primary School,2400SAN1607
22,256,234,84,Zvimba,Zvimba North,Zvimba RDC,13,Ardsisi Primary School,8600ZVI1301
6,454,448,97,Zvimba,Zvimba North,Zvimba RDC,13,Chininga Primary School,8600ZVI1303 A
5,463,458,97,Zvimba,Zvimba North,Zvimba RDC,13,Chininga Primary School,8600ZVI1303 B
27,455,428,88,Zvimba,Zvimba North,Zvimba RDC,13,Conrise Farm Settlement Shed,8600ZVI1305
17,572,555,94,Zvimba,Zvimba North,Zvimba RDC,13,Mafuta Farm Settlement Shed,8600ZVI1306
10,377,367,94,Zvimba,Zvimba North,Zvimba RDC,13,Manga Farm Settlement Shed,8600ZVI1307
41,623,582,87,Zvimba,Zvimba North,Zvimba RDC,13,Minehaha Farm Settlement Shed,8600ZVI1308
59,618,559,82,Zvimba,Zvimba North,Zvimba RDC,13,Pamwechete Primary School,8600ZVI1309
5,593,588,98,Zvimba,Zvimba North,Zvimba RDC,13,Royal Bucks Primary School,8600ZVI1310
3,111,108,94,Zvimba,Zvimba North,Zvimba RDC,13,SS Ranch Farm Tent,8600ZVI1311
19,251,232,85,Zvimba,Zvimba North,Zvimba RDC,13,Zilawa Farm Settlement Shed,8600ZVI1312
41,439,398,82,Zvimba,Zvimba North,Zvimba RDC,14,Great Gain Primary School,8600ZVI1402
24,306,282,85,Zvimba,Zvimba North,Zvimba RDC,14,Inkari Farm Settlement Shed,8600ZVI1403
46,596,550,85,Zvimba,Zvimba North,Zvimba RDC,14,Inyati (Chepstow) Primary School,8600ZVI1404
10,172,162,89,Zvimba,Zvimba North,Zvimba RDC,14,Kelston Park Farm Settlement Shed,8600ZVI1405
21,231,210,83,Zvimba,Zvimba North,Zvimba RDC,14,Rarie Farm Settlement Shed,8600ZVI1407
62,677,615,83,Zvimba,Zvimba North,Zvimba RDC,15,Windsor Primary School,8600ZVI1511
15,242,227,88,Zvimba,Zvimba North,Zvimba RDC,17,Mariondale Farm Settlement Tent,8600ZVI1704
38,536,498,86,Zvimba,Zvimba North,Zvimba RDC,30,Holderness Farm Settlement Tent,8600ZVI3002
38,391,353,82,Zvimba,Zvimba North,Zvimba RDC,30,Mvou Primary School,8600ZVI3004
26,418,392,88,Zvimba,Zvimba North,Zvimba RDC,30,Nchefu Farm Settlement Tent,8600ZVI3005
18,407,389,91,Zvimba,Zvimba North,Zvimba RDC,30,Perth Primary School,8600ZVI3007
20,271,251,86,Zvimba,Zvimba North,Zvimba RDC,31,Junction Farm Settlement Tent,8600ZVI3103
25,325,300,85,Zvimba,Zvimba North,Zvimba RDC,31,Montegomery Farm Settlement Tent,8600ZVI3105
16,173,157,83,Zvimba,Zvimba South,Zvimba RDC,19,Mvebi Farm Tent,8600ZVI1902
32,380,348,84,Zvimba,Zvimba South,Zvimba RDC,32,Maquadzi Primary School,8600ZVI3202
